Acanthus	Acanthaceae
Andrographis	Acanthaceae
Anisacanthus	Acanthaceae
Asystasia	Acanthaceae
Barleria	Acanthaceae
Barleriola	Acanthaceae
Blechum	Acanthaceae
Carlowrightia	Acanthaceae
Crossandra	Acanthaceae
Dicliptera	Acanthaceae
Dyschoriste	Acanthaceae
Elytraria	Acanthaceae
Eranthemum	Acanthaceae
Macuillamia	Scrophulariaceae
Graptophyllum	Acanthaceae
Hemigraphis	Acanthaceae
Henrya	Acanthaceae
Holographis	Acanthaceae
Hygrophila	Acanthaceae
Hypoestes	Acanthaceae
Justicia	Acanthaceae
Megaskepasma	Acanthaceae
Nelsonia	Acanthaceae
Nomaphila	Acanthaceae
Odontonema	Acanthaceae
Oplonia	Acanthaceae
Pachystachys	Acanthaceae
Pseuderanthemum	Acanthaceae
Ruellia	Acanthaceae
Sanchezia	Acanthaceae
Siphonoglossa	Acanthaceae
Leptilon	Asteraceae
Stenandrium	Acanthaceae
Strobilanthes	Acanthaceae
Teliostachya	Acanthaceae
Tetramerium	Acanthaceae
Serinia	Asteraceae
Thunbergia	Acanthaceae
Yeatesia	Acanthaceae
Kuhnia	Asteraceae
Acer	Aceraceae
Acorus	Acoraceae
Leucelene	Asteraceae
Actinidia	Actinidiaceae
Adoxa	Adoxaceae
Agave	Agavaceae
Dracaena	Agavaceae
Furcraea	Agavaceae
Hesperaloe	Agavaceae
Hesperoyucca	Agavaceae
Prionopsis	Asteraceae
Sideranthus	Asteraceae
Manfreda	Agavaceae
Phormium	Agavaceae
Polianthes	Agavaceae
Sansevieria	Agavaceae
Yucca	Agavaceae
Aptenia	Aizoaceae
Carpobrotus	Aizoaceae
Cheiridopsis	Aizoaceae
Conicosia	Aizoaceae
Cypselea	Aizoaceae
Delosperma	Aizoaceae
Disphyma	Aizoaceae
Drosanthemum	Aizoaceae
Galenia	Aizoaceae
Herrea	Aizoaceae
Lampranthus	Aizoaceae
Malephora	Aizoaceae
Mesembryanthemum	Aizoaceae
Psilocaulon	Aizoaceae
Sesuvium	Aizoaceae
Tetragonia	Aizoaceae
Trianthema	Aizoaceae
Alisma	Alismataceae
Baldellia	Alismataceae
Damasonium	Alismataceae
Echinodorus	Alismataceae
Sagittaria	Alismataceae
Aloe	Aloaceae
Achyranthes	Amaranthaceae
Aerva	Amaranthaceae
Alternanthera	Amaranthaceae
Amaranthus	Amaranthaceae
Blutaparon	Amaranthaceae
Celosia	Amaranthaceae
Chamissoa	Amaranthaceae
Charpentiera	Amaranthaceae
Cyathula	Amaranthaceae
Deeringia	Amaranthaceae
Digera	Amaranthaceae
Froelichia	Amaranthaceae
Gomphrena	Amaranthaceae
Gossypianthus	Amaranthaceae
Guilleminea	Amaranthaceae
Hermbstaedtia	Amaranthaceae
Iresine	Amaranthaceae
Lithophila	Amaranthaceae
Nototrichium	Amaranthaceae
Pfaffia	Amaranthaceae
Philoxerus	Amaranthaceae
Psilotrichum	Amaranthaceae
Tidestromia	Amaranthaceae
Anacardium	Anacardiaceae
Buchanania	Anacardiaceae
Campnospera	Anacardiaceae
Choerospondias	Anacardiaceae
Comocladia	Anacardiaceae
Cotinus	Anacardiaceae
Dracontomelon	Anacardiaceae
Gluta	Anacardiaceae
Lithrea	Anacardiaceae
Malosma	Anacardiaceae
Mangifera	Anacardiaceae
Melanorrhoea	Anacardiaceae
Metopium	Anacardiaceae
Pistacia	Anacardiaceae
Rhus	Anacardiaceae
Schinopsis	Anacardiaceae
Schinus	Anacardiaceae
Sclerocarya	Anacardiaceae
Searsia	Anacardiaceae
Semecarpus	Anacardiaceae
Spondias	Anacardiaceae
Toxicodendron	Anacardiaceae
Anemia	Anemiaceae
Annona	Annonaceae
Artabotrys	Annonaceae
Asimina	Annonaceae
Cananga	Annonaceae
Deeringothamnus	Annonaceae
Friesodielsia	Annonaceae
Guamia	Annonaceae
Guatteria	Annonaceae
Monodora	Annonaceae
Oxandra	Annonaceae
Rollinia	Annonaceae
Stelechocarpus	Annonaceae
Xylopia	Annonaceae
Aciphylla	Apiaceae
Aegopodium	Apiaceae
Aethusa	Apiaceae
Aletes	Apiaceae
Ammi	Apiaceae
Ammoselinum	Apiaceae
Anethum	Apiaceae
Angelica	Apiaceae
Anthriscus	Apiaceae
Apiastrum	Apiaceae
Apium	Apiaceae
Arracacia	Apiaceae
Berula	Apiaceae
Bifora	Apiaceae
Bowlesia	Apiaceae
Bupleurum	Apiaceae
Carum	Apiaceae
Caucalis	Apiaceae
Centella	Apiaceae
Chaerophyllum	Apiaceae
Cicuta	Apiaceae
Cnidium	Apiaceae
Conioselinum	Apiaceae
Conium	Apiaceae
Coriandrum	Apiaceae
Cryptotaenia	Apiaceae
Cuminum	Apiaceae
Cyclospermum	Apiaceae
Cymopterus	Apiaceae
Cynosciadium	Apiaceae
Daucosma	Apiaceae
Daucus	Apiaceae
Dorema	Apiaceae
Erigenia	Apiaceae
Eryngium	Apiaceae
Eurytaenia	Apiaceae
Falcaria	Apiaceae
Ferula	Apiaceae
Foeniculum	Apiaceae
Glehnia	Apiaceae
Harbouria	Apiaceae
Heracleum	Apiaceae
Hydrocotyle	Apiaceae
Levisticum	Apiaceae
Ligusticum	Apiaceae
Lilaeopsis	Apiaceae
Limnosciadium	Apiaceae
Lomatium	Apiaceae
Musineon	Apiaceae
Myrrhis	Apiaceae
Neoparrya	Apiaceae
Oenanthe	Apiaceae
Oreonana	Apiaceae
Oreoxis	Apiaceae
Orogenia	Apiaceae
Osmorhiza	Apiaceae
Oxypolis	Apiaceae
Pastinaca	Apiaceae
Perideridia	Apiaceae
Petroselinum	Apiaceae
Peucedanum	Apiaceae
Phlojodicarpus	Apiaceae
Pimpinella	Apiaceae
Podistera	Apiaceae
Polytaenia	Apiaceae
Pseudocymopterus	Apiaceae
Pteryxia	Apiaceae
Ptilimnium	Apiaceae
Sanicula	Apiaceae
Scandix	Apiaceae
Selinum	Apiaceae
Seseli	Apiaceae
Shoshonea	Apiaceae
Sium	Apiaceae
Smyrnium	Apiaceae
Spermolepis	Apiaceae
Sphenosciadium	Apiaceae
Synelcosciadium	Apiaceae
Taenidia	Apiaceae
Tauschia	Apiaceae
Thaspium	Apiaceae
Tilingia	Apiaceae
Tordylium	Apiaceae
Torilis	Apiaceae
Trachyspermum	Apiaceae
Trepocarpus	Apiaceae
Turgenia	Apiaceae
Yabea	Apiaceae
Zizia	Apiaceae
Adenium	Apocynaceae
Allamanda	Apocynaceae
Alstonia	Apocynaceae
Alyxia	Apocynaceae
Amsonia	Apocynaceae
Anechites	Apocynaceae
Angadenia	Apocynaceae
Apocynum	Apocynaceae
Carissa	Apocynaceae
Catharanthus	Apocynaceae
Cerbera	Apocynaceae
Cycladenia	Apocynaceae
Dyera	Apocynaceae
Echites	Apocynaceae
Fernaldia	Apocynaceae
Forsteronia	Apocynaceae
Funtumia	Apocynaceae
Hancornia	Apocynaceae
Haplophyton	Apocynaceae
Holarrhena	Apocynaceae
Landolphia	Apocynaceae
Lepinia	Apocynaceae
Macrosiphonia	Apocynaceae
Neisosperma	Apocynaceae
Nerium	Apocynaceae
Ochrosia	Apocynaceae
Pentalinon	Apocynaceae
Plumeria	Apocynaceae
Prestonia	Apocynaceae
Pteralyxia	Apocynaceae
Rauvolfia	Apocynaceae
Rhabdadenia	Apocynaceae
Saba	Apocynaceae
Strophanthus	Apocynaceae
Tabernaemontana	Apocynaceae
Thevetia	Apocynaceae
Trachelospermum	Apocynaceae
Tylophora	Apocynaceae
Vallesia	Apocynaceae
Vinca	Apocynaceae
Aponogeton	Aponogetonaceae
Ilex	Aquifoliaceae
Nemopanthus	Aquifoliaceae
Aglaonema	Araceae
Alocasia	Araceae
Amorphophallus	Araceae
Anthurium	Araceae
Arisaema	Araceae
Arum	Araceae
Caladium	Araceae
Calla	Araceae
Colocasia	Araceae
Cryptocoryne	Araceae
Cyrtosperma	Araceae
Dieffenbachia	Araceae
Dracontium	Araceae
Dracunculus	Araceae
Epipremnum	Araceae
Homalomena	Araceae
Lysichiton	Araceae
Monstera	Araceae
Montrichardia	Araceae
Orontium	Araceae
Peltandra	Araceae
Philodendron	Araceae
Pinellia	Araceae
Pistia	Araceae
Symplocarpus	Araceae
Syngonium	Araceae
Typhonium	Araceae
Xanthosoma	Araceae
Zantedeschia	Araceae
Aralia	Araliaceae
Cheirodendron	Araliaceae
Dendropanax	Araliaceae
Eleutherococcus	Araliaceae
Fatsia	Araliaceae
Hedera	Araliaceae
Kalopanax	Araliaceae
Meryta	Araliaceae
Munroidendron	Araliaceae
Oplopanax	Araliaceae
Osmoxylon	Araliaceae
Panax	Araliaceae
Polyscias	Araliaceae
Pseudopanax	Araliaceae
Reynoldsia	Araliaceae
Schefflera	Araliaceae
Tetrapanax	Araliaceae
Tetraplasandra	Araliaceae
Agathis	Araucariaceae
Araucaria	Araucariaceae
Acoelorraphe	Arecaceae
Acrocomia	Arecaceae
Aiphanes	Arecaceae
Archontophoenix	Arecaceae
Areca	Arecaceae
Arecastrum	Arecaceae
Arenga	Arecaceae
Attalea	Arecaceae
Bactris	Arecaceae
Borassus	Arecaceae
Butia	Arecaceae
Calamus	Arecaceae
Calyptronoma	Arecaceae
Caryota	Arecaceae
Ceroxylon	Arecaceae
Chamaedorea	Arecaceae
Chamaerops	Arecaceae
Coccothrinax	Arecaceae
Cocos	Arecaceae
Copernicia	Arecaceae
Dypsis	Arecaceae
Elaeis	Arecaceae
Eremospatha	Arecaceae
Eugeissona	Arecaceae
Euterpe	Arecaceae
Gaussia	Arecaceae
Heterospathe	Arecaceae
Howeia	Arecaceae
Hyphaene	Arecaceae
Jubaea	Arecaceae
Leopoldinia	Arecaceae
Linospadix	Arecaceae
Livistona	Arecaceae
Lodoicea	Arecaceae
Mauritia	Arecaceae
Metroxylon	Arecaceae
Nypa	Arecaceae
Orbignya	Arecaceae
Phoenix	Arecaceae
Phytelephas	Arecaceae
Pinanga	Arecaceae
Prestoea	Arecaceae
Pritchardia	Arecaceae
Pseudophoenix	Arecaceae
Ptychosperma	Arecaceae
Raphia	Arecaceae
Rhapidophyllum	Arecaceae
Roystonea	Arecaceae
Sabal	Arecaceae
Salacca	Arecaceae
Serenoa	Arecaceae
Syagrus	Arecaceae
Thrinax	Arecaceae
Trachycarpus	Arecaceae
Washingtonia	Arecaceae
Aristolochia	Aristolochiaceae
Asarum	Aristolochiaceae
Hexastylis	Aristolochiaceae
Araujia	Asclepiadaceae
Asclepias	Asclepiadaceae
Calotropis	Asclepiadaceae
Caralluma	Asclepiadaceae
Ceropegia	Asclepiadaceae
Cryptostegia	Asclepiadaceae
Cynanchum	Asclepiadaceae
Dischidia	Asclepiadaceae
Edithcolea	Asclepiadaceae
Funastrum	Asclepiadaceae
Gonolobus	Asclepiadaceae
Gymnema	Asclepiadaceae
Hoya	Asclepiadaceae
Marsdenia	Asclepiadaceae
Matelea	Asclepiadaceae
Metaplexis	Asclepiadaceae
Morrenia	Asclepiadaceae
Orbea	Asclepiadaceae
Oxypetalum	Asclepiadaceae
Pergularia	Asclepiadaceae
Periploca	Asclepiadaceae
Podostigma	Asclepiadaceae
Stapelia	Asclepiadaceae
Telosma	Asclepiadaceae
Asplenium	Aspleniaceae
Diellia	Aspleniaceae
Acamptopappus	Asteraceae
Acanthospermum	Asteraceae
Achillea	Asteraceae
Achyrachaena	Asteraceae
Acmella	Asteraceae
Acourtia	Asteraceae
Acroptilon	Asteraceae
Adenocaulon	Asteraceae
Adenophyllum	Asteraceae
Adenostemma	Asteraceae
Ageratina	Asteraceae
Ageratum	Asteraceae
Agnorhiza	Asteraceae
Agoseris	Asteraceae
Almutaster	Asteraceae
Amberboa	Asteraceae
Amblyolepis	Asteraceae
Amblyopappus	Asteraceae
Ambrosia	Asteraceae
Ampelaster	Asteraceae
Amphiachyris	Asteraceae
Amphipappus	Asteraceae
Anacyclus	Asteraceae
Anaphalis	Asteraceae
Ancistrocarphus	Asteraceae
Anisocarpus	Asteraceae
Anisocoma	Asteraceae
Antennaria	Asteraceae
Anthemis	Asteraceae
Antheropeas	Asteraceae
Aphanostephus	Asteraceae
Arctium	Asteraceae
Arctotheca	Asteraceae
Arctotis	Asteraceae
Argyranthemum	Asteraceae
Argyrautia	Asteraceae
Argyroxiphium	Asteraceae
Arnica	Asteraceae
Arnoglossum	Asteraceae
Arnoseris	Asteraceae
Artemisia	Asteraceae
Asanthus	Asteraceae
Aster	Asteraceae
Astranthium	Asteraceae
Atrichoseris	Asteraceae
Baccharis	Asteraceae
Bahia	Asteraceae
Baileya	Asteraceae
Balduina	Asteraceae
Balsamorhiza	Asteraceae
Baltimora	Asteraceae
Barkleyanthus	Asteraceae
Bartlettia	Asteraceae
Bartlettina	Asteraceae
Bebbia	Asteraceae
Bellis	Asteraceae
Benitoa	Asteraceae
Berkheya	Asteraceae
Berlandiera	Asteraceae
Bidens	Asteraceae
Bigelowia	Asteraceae
Blennosperma	Asteraceae
Blepharipappus	Asteraceae
Blepharizonia	Asteraceae
Blumea	Asteraceae
Boltonia	Asteraceae
Bombycilaena	Asteraceae
Borrichia	Asteraceae
Bracteantha	Asteraceae
Brickellia	Asteraceae
Brickelliastrum	Asteraceae
Buphthalmum	Asteraceae
Cacaliopsis	Asteraceae
Calendula	Asteraceae
Callistephus	Asteraceae
Calotis	Asteraceae
Calycadenia	Asteraceae
Calycoseris	Asteraceae
Calyptocarpus	Asteraceae
Canadanthus	Asteraceae
Carduus	Asteraceae
Carlina	Asteraceae
Carlquistia	Asteraceae
Carminatia	Asteraceae
Carphephorus	Asteraceae
Carphochaete	Asteraceae
Carthamus	Asteraceae
Castalis	Asteraceae
Catananche	Asteraceae
Celmisia	Asteraceae
Centaurea	Asteraceae
Centipeda	Asteraceae
Centratherum	Asteraceae
Centromadia	Asteraceae
Chaenactis	Asteraceae
Chaetadelpha	Asteraceae
Chaetopappa	Asteraceae
Chamaechaenactis	Asteraceae
Chamaemelum	Asteraceae
Chaptalia	Asteraceae
Chloracantha	Asteraceae
Chondrilla	Asteraceae
Chorisiva	Asteraceae
Chromolaena	Asteraceae
Chrysactinia	Asteraceae
Chrysanthellum	Asteraceae
Chrysanthemum	Asteraceae
Chrysogonum	Asteraceae
Chrysoma	Asteraceae
Chrysopsis	Asteraceae
Chrysothamnus	Asteraceae
Cichorium	Asteraceae
Cineraria	Asteraceae
Cirsium	Asteraceae
Clappia	Asteraceae
Clibadium	Asteraceae
Cnicus	Asteraceae
Columbiadoria	Asteraceae
Condylidium	Asteraceae
Conoclinium	Asteraceae
Constancea	Asteraceae
Conyza	Asteraceae
Coreocarpus	Asteraceae
Coreopsis	Asteraceae
Corethrogyne	Asteraceae
Cosmos	Asteraceae
Cotula	Asteraceae
Crassocephalum	Asteraceae
Crepis	Asteraceae
Critonia	Asteraceae
Crocidium	Asteraceae
Croptilon	Asteraceae
Crupina	Asteraceae
Cyanopsis	Asteraceae
Cyanthillium	Asteraceae
Cyclachaena	Asteraceae
Cymophora	Asteraceae
Cynara	Asteraceae
Dahlia	Asteraceae
Deinandra	Asteraceae
Delairea	Asteraceae
Dendranthema	Asteraceae
Dichaetophora	Asteraceae
Dicoria	Asteraceae
Dicranocarpus	Asteraceae
Dimeresia	Asteraceae
Dimorphotheca	Asteraceae
Dittrichia	Asteraceae
Doellingeria	Asteraceae
Doronicum	Asteraceae
Dracopis	Asteraceae
Dubautia	Asteraceae
Dysodiopsis	Asteraceae
Dyssodia	Asteraceae
Eastwoodia	Asteraceae
Eatonella	Asteraceae
Echinacea	Asteraceae
Echinops	Asteraceae
Eclipta	Asteraceae
Egletes	Asteraceae
Elephantopus	Asteraceae
Eleutheranthera	Asteraceae
Emilia	Asteraceae
Encelia	Asteraceae
Enceliopsis	Asteraceae
Engelmannia	Asteraceae
Enydra	Asteraceae
Epaltes	Asteraceae
Erechtites	Asteraceae
Ericameria	Asteraceae
Erigeron	Asteraceae
Eriophyllum	Asteraceae
Erlangea	Asteraceae
Espeletia	Asteraceae
Eucephalus	Asteraceae
Euchiton	Asteraceae
Eupatoriadelphus	Asteraceae
Eupatorium	Asteraceae
Eurybia	Asteraceae
Euryops	Asteraceae
Euthamia	Asteraceae
Evax	Asteraceae
Facelis	Asteraceae
Felicia	Asteraceae
Filago	Asteraceae
Filifolium	Asteraceae
Fitchia	Asteraceae
Flaveria	Asteraceae
Fleischmannia	Asteraceae
Florestina	Asteraceae
Flourensia	Asteraceae
Flyriella	Asteraceae
Gaillardia	Asteraceae
Galatella	Asteraceae
Galinsoga	Asteraceae
Gamochaeta	Asteraceae
Garberia	Asteraceae
Gazania	Asteraceae
Geraea	Asteraceae
Gerbera	Asteraceae
Glebionis	Asteraceae
Glossogyne	Asteraceae
Glyptopleura	Asteraceae
Gnaphalium	Asteraceae
Gochnatia	Asteraceae
Grindelia	Asteraceae
Guardiola	Asteraceae
Guizotia	Asteraceae
Gundelia	Asteraceae
Gundlachia	Asteraceae
Gutierrezia	Asteraceae
Gymnosperma	Asteraceae
Gymnostyles	Asteraceae
Gynura	Asteraceae
Haplocarpha	Asteraceae
Haploesthes	Asteraceae
Haplopappus	Asteraceae
Harmonia	Asteraceae
Hartwrightia	Asteraceae
Hasteola	Asteraceae
Hazardia	Asteraceae
Hebeclinium	Asteraceae
Hecastocleis	Asteraceae
Hedosyne	Asteraceae
Hedypnois	Asteraceae
Helenium	Asteraceae
Helianthella	Asteraceae
Helianthus	Asteraceae
Helichrysum	Asteraceae
Heliomeris	Asteraceae
Heliopsis	Asteraceae
Hemizonella	Asteraceae
Hemizonia	Asteraceae
Hertia	Asteraceae
Hesperevax	Asteraceae
Hesperodoria	Asteraceae
Hesperomannia	Asteraceae
Heteranthemis	Asteraceae
Heteropappus	Asteraceae
Heterosperma	Asteraceae
Heterotheca	Asteraceae
Hieracium	Asteraceae
Holocarpha	Asteraceae
Holozonia	Asteraceae
Hulsea	Asteraceae
Hulteniella	Asteraceae
Hymenoclea	Asteraceae
Hymenopappus	Asteraceae
Hymenothrix	Asteraceae
Hymenoxys	Asteraceae
Hypochaeris	Asteraceae
Hypochoeris	Asteraceae
Inula	Asteraceae
Ionactis	Asteraceae
Isocarpha	Asteraceae
Isocoma	Asteraceae
Iva	Asteraceae
Ixeris	Asteraceae
Jamesianthus	Asteraceae
Jaumea	Asteraceae
Jefea	Asteraceae
Jensia	Asteraceae
Kalimeris	Asteraceae
Keysseria	Asteraceae
Kleinia	Asteraceae
Koanophyllon	Asteraceae
Krigia	Asteraceae
Kyhosia	Asteraceae
Lactuca	Asteraceae
Laennecia	Asteraceae
Lagascea	Asteraceae
Lagophylla	Asteraceae
Lapsana	Asteraceae
Lapsanastrum	Asteraceae
Lasianthaea	Asteraceae
Lasiospermum	Asteraceae
Lasthenia	Asteraceae
Launaea	Asteraceae
Layia	Asteraceae
Leibnitzia	Asteraceae
Leontodon	Asteraceae
Lepidospartum	Asteraceae
Lessingia	Asteraceae
Leucanthemella	Asteraceae
Leucanthemum	Asteraceae
Leuciva	Asteraceae
Liatris	Asteraceae
Ligularia	Asteraceae
Lindheimera	Asteraceae
Lipochaeta	Asteraceae
Logfia	Asteraceae
Luina	Asteraceae
Lygodesmia	Asteraceae
Machaeranthera	Asteraceae
Madia	Asteraceae
Malacothrix	Asteraceae
Malperia	Asteraceae
Mantisalca	Asteraceae
Marshallia	Asteraceae
Matricaria	Asteraceae
Melampodium	Asteraceae
Melanthera	Asteraceae
Micropus	Asteraceae
Microseris	Asteraceae
Mikania	Asteraceae
Monolopia	Asteraceae
Monoptilon	Asteraceae
Montanoa	Asteraceae
Mycelis	Asteraceae
Neurolaena	Asteraceae
Nicolletia	Asteraceae
Nipponanthemum	Asteraceae
Nothocalais	Asteraceae
Oclemena	Asteraceae
Olearia	Asteraceae
Oligoneuron	Asteraceae
Omalotheca	Asteraceae
Oncosiphon	Asteraceae
Onopordum	Asteraceae
Oonopsis	Asteraceae
Oreochrysum	Asteraceae
Oreostemma	Asteraceae
Orochaenactis	Asteraceae
Osmadenia	Asteraceae
Osteospermum	Asteraceae
Oxytenia	Asteraceae
Packera	Asteraceae
Palafoxia	Asteraceae
Parasenecio	Asteraceae
Parthenice	Asteraceae
Parthenium	Asteraceae
Pascalia	Asteraceae
Pectis	Asteraceae
Pentachaeta	Asteraceae
Pentzia	Asteraceae
Perezia	Asteraceae
Pericallis	Asteraceae
Pericome	Asteraceae
Perityle	Asteraceae
Petasites	Asteraceae
Petradoria	Asteraceae
Peucephyllum	Asteraceae
Phalacroseris	Asteraceae
Phoebanthus	Asteraceae
Phymaspermum	Asteraceae
Picradeniopsis	Asteraceae
Picris	Asteraceae
Picrothamnus	Asteraceae
Pinaropappus	Asteraceae
Piptocarpha	Asteraceae
Piptocoma	Asteraceae
Pityopsis	Asteraceae
Plateilema	Asteraceae
Platyschkuhria	Asteraceae
Pleiacanthus	Asteraceae
Pleurocoronis	Asteraceae
Pluchea	Asteraceae
Podocoma	Asteraceae
Polymnia	Asteraceae
Porophyllum	Asteraceae
Prenanthella	Asteraceae
Prenanthes	Asteraceae
Proustia	Asteraceae
Psacalium	Asteraceae
Psathyrotes	Asteraceae
Psathyrotopsis	Asteraceae
Pseudelephantopus	Asteraceae
Pseudobahia	Asteraceae
Pseudoclappia	Asteraceae
Pseudognaphalium	Asteraceae
Pseudogynoxys	Asteraceae
Psilactis	Asteraceae
Psilocarphus	Asteraceae
Psilostrophe	Asteraceae
Pterocaulon	Asteraceae
Pulicaria	Asteraceae
Pyrrhopappus	Asteraceae
Pyrrocoma	Asteraceae
Rafinesquia	Asteraceae
Raillardella	Asteraceae
Rainiera	Asteraceae
Ratibida	Asteraceae
Rayjacksonia	Asteraceae
Reichardia	Asteraceae
Remya	Asteraceae
Rhagadiolus	Asteraceae
Rhodanthe	Asteraceae
Rigiopappus	Asteraceae
Rolandra	Asteraceae
Roldana	Asteraceae
Rudbeckia	Asteraceae
Rugelia	Asteraceae
Sachsia	Asteraceae
Salmea	Asteraceae
Santolina	Asteraceae
Sanvitalia	Asteraceae
Sartwellia	Asteraceae
Saussurea	Asteraceae
Scabrethia	Asteraceae
Schkuhria	Asteraceae
Sclerocarpus	Asteraceae
Sclerolepis	Asteraceae
Scolymus	Asteraceae
Scorzonera	Asteraceae
Senecio	Asteraceae
Sericocarpus	Asteraceae
Serratula	Asteraceae
Shinnersoseris	Asteraceae
Sigesbeckia	Asteraceae
Silphium	Asteraceae
Silybum	Asteraceae
Simsia	Asteraceae
Smallanthus	Asteraceae
Solidago	Asteraceae
Solidaster	Asteraceae
Soliva	Asteraceae
Sonchus	Asteraceae
Sphaeromeria	Asteraceae
Sphagneticola	Asteraceae
Spilanthes	Asteraceae
Spiracantha	Asteraceae
Stenotus	Asteraceae
Stephanomeria	Asteraceae
Stevia	Asteraceae
Stokesia	Asteraceae
Struchium	Asteraceae
Stylocline	Asteraceae
Symphyotrichum	Asteraceae
Synedrella	Asteraceae
Syntrichopappus	Asteraceae
Tagetes	Asteraceae
Tamaulipa	Asteraceae
Tanacetum	Asteraceae
Taraxacum	Asteraceae
Tephroseris	Asteraceae
Tetradymia	Asteraceae
Tetragonotheca	Asteraceae
Tetramolopium	Asteraceae
Tetraneuris	Asteraceae
Thelesperma	Asteraceae
Thurovia	Asteraceae
Thymophylla	Asteraceae
Tithonia	Asteraceae
Tolpis	Asteraceae
Tonestus	Asteraceae
Townsendia	Asteraceae
Tracyina	Asteraceae
Tragopogon	Asteraceae
Trichocoronis	Asteraceae
Trichoptilium	Asteraceae
Tridax	Asteraceae
Trilisa	Asteraceae
Tripleurospermum	Asteraceae
Tripolium	Asteraceae
Trixis	Asteraceae
Tussilago	Asteraceae
Urospermum	Asteraceae
Vanclevea	Asteraceae
Varilla	Asteraceae
Venegasia	Asteraceae
Venidium	Asteraceae
Verbesina	Asteraceae
Vernonia	Asteraceae
Vesicarpa	Asteraceae
Viguiera	Asteraceae
Wedelia	Asteraceae
Wilkesia	Asteraceae
Wollastonia	Asteraceae
Wyethia	Asteraceae
Xanthisma	Asteraceae
Xanthium	Asteraceae
Xanthocephalum	Asteraceae
Xylorhiza	Asteraceae
Xylothamia	Asteraceae
Yermo	Asteraceae
Youngia	Asteraceae
Zinnia	Asteraceae
Azolla	Azollaceae
Balanophora	Balanophoraceae
Scybalium	Balanophoraceae
Impatiens	Balsaminaceae
Anredera	Basellaceae
Basella	Basellaceae
Ullucus	Basellaceae
Batis	Bataceae
Begonia	Begoniaceae
Hillebrandia	Begoniaceae
Achlys	Berberidaceae
Berberis	Berberidaceae
Caulophyllum	Berberidaceae
Diphylleia	Berberidaceae
Epimedium	Berberidaceae
Jeffersonia	Berberidaceae
Mahoberberis	Berberidaceae
Mahonia	Berberidaceae
Nandina	Berberidaceae
Podophyllum	Berberidaceae
Vancouveria	Berberidaceae
Alnus	Betulaceae
Betula	Betulaceae
Carpinus	Betulaceae
Corylus	Betulaceae
Nothofagus	Betulaceae
Ostrya	Betulaceae
Amphilophium	Bignoniaceae
Amphitecna	Bignoniaceae
Arrabidaea	Bignoniaceae
Bignonia	Bignoniaceae
Campsis	Bignoniaceae
Catalpa	Bignoniaceae
Chilopsis	Bignoniaceae
Crescentia	Bignoniaceae
Cydista	Bignoniaceae
Distictis	Bignoniaceae
Dolichandrone	Bignoniaceae
Incarvillea	Bignoniaceae
Jacaranda	Bignoniaceae
Kigelia	Bignoniaceae
Macfadyena	Bignoniaceae
Mansoa	Bignoniaceae
Markhamia	Bignoniaceae
Parmentiera	Bignoniaceae
Pithecoctenium	Bignoniaceae
Podranea	Bignoniaceae
Pseudocalymma	Bignoniaceae
Pyrostegia	Bignoniaceae
Saritaea	Bignoniaceae
Schlegelia	Bignoniaceae
Spathodea	Bignoniaceae
Tabebuia	Bignoniaceae
Tecoma	Bignoniaceae
Tecomanthe	Bignoniaceae
Tynanthus	Bignoniaceae
Amoreuxia	Bixaceae
Bixa	Bixaceae
Cochlospermum	Bixaceae
Blechnum	Blechnaceae
Doodia	Blechnaceae
Sadleria	Blechnaceae
Stenochlaena	Blechnaceae
Woodwardia	Blechnaceae
Adansonia	Bombacaceae
Bombax	Bombacaceae
Ceiba	Bombacaceae
Chorisia	Bombacaceae
Durio	Bombacaceae
Ochroma	Bombacaceae
Pachira	Bombacaceae
Pseudobombax	Bombacaceae
Quararibea	Bombacaceae
Alkanna	Boraginaceae
Amsinckia	Boraginaceae
Anchusa	Boraginaceae
Antiphytum	Boraginaceae
Argusia	Boraginaceae
Asperugo	Boraginaceae
Borago	Boraginaceae
Bothriospermum	Boraginaceae
Bourreria	Boraginaceae
Brunnera	Boraginaceae
Buglossoides	Boraginaceae
Carmona	Boraginaceae
Cordia	Boraginaceae
Cryptantha	Boraginaceae
Cynoglossum	Boraginaceae
Dasynotus	Boraginaceae
Echium	Boraginaceae
Ehretia	Boraginaceae
Eritrichium	Boraginaceae
Hackelia	Boraginaceae
Harpagonella	Boraginaceae
Heliotropium	Boraginaceae
Lappula	Boraginaceae
Lindelofia	Boraginaceae
Lithospermum	Boraginaceae
Macromeria	Boraginaceae
Mertensia	Boraginaceae
Myosotidium	Boraginaceae
Myosotis	Boraginaceae
Nonea	Boraginaceae
Omphalodes	Boraginaceae
Onosma	Boraginaceae
Onosmodium	Boraginaceae
Pectocarya	Boraginaceae
Pentaglottis	Boraginaceae
Plagiobothrys	Boraginaceae
Pulmonaria	Boraginaceae
Rochefortia	Boraginaceae
Symphytum	Boraginaceae
Tiquilia	Boraginaceae
Tournefortia	Boraginaceae
Alliaria	Brassicaceae
Alyssoides	Brassicaceae
Alyssum	Brassicaceae
Anelsonia	Brassicaceae
Aphragmus	Brassicaceae
Arabidopsis	Brassicaceae
Arabis	Brassicaceae
Armoracia	Brassicaceae
Athysanus	Brassicaceae
Aubrieta	Brassicaceae
Aurinia	Brassicaceae
Barbarea	Brassicaceae
Berteroa	Brassicaceae
Brassica	Brassicaceae
Braya	Brassicaceae
Bunias	Brassicaceae
Cakile	Brassicaceae
Calepina	Brassicaceae
Camelina	Brassicaceae
Capsella	Brassicaceae
Cardamine	Brassicaceae
Cardaminopsis	Brassicaceae
Cardaria	Brassicaceae
Caulanthus	Brassicaceae
Caulostramina	Brassicaceae
Chlorocrambe	Brassicaceae
Chorispora	Brassicaceae
Christolea	Brassicaceae
Cochlearia	Brassicaceae
Coincya	Brassicaceae
Conringia	Brassicaceae
Coronopus	Brassicaceae
Crambe	Brassicaceae
Cusickiella	Brassicaceae
Descurainia	Brassicaceae
Dimorphocarpa	Brassicaceae
Diplotaxis	Brassicaceae
Dithyrea	Brassicaceae
Draba	Brassicaceae
Dryopetalon	Brassicaceae
Eruca	Brassicaceae
Erucastrum	Brassicaceae
Erysimum	Brassicaceae
Euclidium	Brassicaceae
Eutrema	Brassicaceae
Glaucocarpum	Brassicaceae
Guillenia	Brassicaceae
Halimolobos	Brassicaceae
Hesperis	Brassicaceae
Heterodraba	Brassicaceae
Hirschfeldia	Brassicaceae
Hornungia	Brassicaceae
Iberis	Brassicaceae
Idahoa	Brassicaceae
Iodanthus	Brassicaceae
Ionopsidium	Brassicaceae
Isatis	Brassicaceae
Leavenworthia	Brassicaceae
Lepidium	Brassicaceae
Lesquerella	Brassicaceae
Lobularia	Brassicaceae
Lunaria	Brassicaceae
Lyrocarpa	Brassicaceae
Malcolmia	Brassicaceae
Mancoa	Brassicaceae
Matthiola	Brassicaceae
Microthlaspi	Brassicaceae
Moricandia	Brassicaceae
Myagrum	Brassicaceae
Nasturtium	Brassicaceae
Neobeckia	Brassicaceae
Neotorularia	Brassicaceae
Nerisyrenia	Brassicaceae
Neslia	Brassicaceae
Noccaea	Brassicaceae
Parrya	Brassicaceae
Pennellia	Brassicaceae
Phoenicaulis	Brassicaceae
Physaria	Brassicaceae
Polyctenium	Brassicaceae
Raphanus	Brassicaceae
Rapistrum	Brassicaceae
Rorippa	Brassicaceae
Schoenocrambe	Brassicaceae
Selenia	Brassicaceae
Sibara	Brassicaceae
Sibaropsis	Brassicaceae
Sinapis	Brassicaceae
Sisymbrium	Brassicaceae
Smelowskia	Brassicaceae
Stanfordia	Brassicaceae
Stanleya	Brassicaceae
Streptanthella	Brassicaceae
Streptanthus	Brassicaceae
Stroganowia	Brassicaceae
Subularia	Brassicaceae
Synthlipsis	Brassicaceae
Teesdalia	Brassicaceae
Thellungiella	Brassicaceae
Thelypodiopsis	Brassicaceae
Thelypodium	Brassicaceae
Thlaspi	Brassicaceae
Thysanocarpus	Brassicaceae
Tropidocarpum	Brassicaceae
Twisselmannia	Brassicaceae
Warea	Brassicaceae
Wasabia	Brassicaceae
Aechmea	Bromeliaceae
Ananas	Bromeliaceae
Billbergia	Bromeliaceae
Bromelia	Bromeliaceae
Catopsis	Bromeliaceae
Dyckia	Bromeliaceae
Guzmania	Bromeliaceae
Hechtia	Bromeliaceae
Hohenbergia	Bromeliaceae
Neoregelia	Bromeliaceae
Pitcairnia	Bromeliaceae
Tillandsia	Bromeliaceae
Vriesea	Bromeliaceae
Brunellia	Brunelliaceae
Buddleja	Buddlejaceae
Emorya	Buddlejaceae
Polypremum	Buddlejaceae
Apteria	Burmanniaceae
Burmannia	Burmanniaceae
Cymbocarpa	Burmanniaceae
Gymnosiphon	Burmanniaceae
Thismia	Burmanniaceae
Boswellia	Burseraceae
Bursera	Burseraceae
Canarium	Burseraceae
Commiphora	Burseraceae
Dacryodes	Burseraceae
Tetragastris	Burseraceae
Butomus	Butomaceae
Buxus	Buxaceae
Pachysandra	Buxaceae
Brasenia	Cabombaceae
Cabomba	Cabombaceae
Acanthocereus	Cactaceae
Ariocarpus	Cactaceae
Astrophytum	Cactaceae
Bergerocactus	Cactaceae
Borzicactus	Cactaceae
Brasiliopuntia	Cactaceae
Carnegiea	Cactaceae
Cephalocereus	Cactaceae
Cereus	Cactaceae
Cleistocactus	Cactaceae
Consolea	Cactaceae
Corryocactus	Cactaceae
Coryphantha	Cactaceae
Cylindropuntia	Cactaceae
Eccremocactus	Cactaceae
Echinocactus	Cactaceae
Echinocereus	Cactaceae
Echinomastus	Cactaceae
Echinopsis	Cactaceae
Epiphyllum	Cactaceae
Epithelantha	Cactaceae
Escobaria	Cactaceae
Ferocactus	Cactaceae
Grusonia	Cactaceae
Hamatocactus	Cactaceae
Harrisia	Cactaceae
Hatiora	Cactaceae
Hylocereus	Cactaceae
Leptocereus	Cactaceae
Lobivia	Cactaceae
Lophophora	Cactaceae
Mammillaria	Cactaceae
Melocactus	Cactaceae
Neolloydia	Cactaceae
Notocactus	Cactaceae
Opuntia	Cactaceae
Pachycereus	Cactaceae
Parodia	Cactaceae
Pediocactus	Cactaceae
Peniocereus	Cactaceae
Pereskia	Cactaceae
Pilosocereus	Cactaceae
Rebutia	Cactaceae
Rhipsalis	Cactaceae
Schlumbergera	Cactaceae
Sclerocactus	Cactaceae
Selenicereus	Cactaceae
Stenocereus	Cactaceae
Thelocactus	Cactaceae
Trichocereus	Cactaceae
Wigginsia	Cactaceae
Callitriche	Callitrichaceae
Calycanthus	Calycanthaceae
Acicarpha	Calyceraceae
Calycera	Calyceraceae
Asyneuma	Campanulaceae
Brighamia	Campanulaceae
Campanula	Campanulaceae
Campanulastrum	Campanulaceae
Canarina	Campanulaceae
Clermontia	Campanulaceae
Codonopsis	Campanulaceae
Cyanea	Campanulaceae
Delissea	Campanulaceae
Downingia	Campanulaceae
Gadellia	Campanulaceae
Githopsis	Campanulaceae
Heterocodon	Campanulaceae
Hippobroma	Campanulaceae
Howellia	Campanulaceae
Jasione	Campanulaceae
Legenere	Campanulaceae
Legousia	Campanulaceae
Lobelia	Campanulaceae
Nemacladus	Campanulaceae
Parishella	Campanulaceae
Platycodon	Campanulaceae
Porterella	Campanulaceae
Rollandia	Campanulaceae
Trematolobelia	Campanulaceae
Triodanis	Campanulaceae
Wahlenbergia	Campanulaceae
Canella	Canellaceae
Pleodendron	Canellaceae
Cannabis	Cannabaceae
Humulus	Cannabaceae
Canna	Cannaceae
Atamisquea	Capparaceae
Boscia	Capparaceae
Cadaba	Capparaceae
Capparis	Capparaceae
Cleome	Capparaceae
Cleomella	Capparaceae
Crateva	Capparaceae
Forchhammeria	Capparaceae
Koeberlinia	Capparaceae
Maerua	Capparaceae
Morisonia	Capparaceae
Oxystylis	Capparaceae
Polanisia	Capparaceae
Wislizenia	Capparaceae
Abelia	Caprifoliaceae
Diervilla	Caprifoliaceae
Kolkwitzia	Caprifoliaceae
Leycesteria	Caprifoliaceae
Linnaea	Caprifoliaceae
Lonicera	Caprifoliaceae
Sambucus	Caprifoliaceae
Symphoricarpos	Caprifoliaceae
Triosteum	Caprifoliaceae
Viburnum	Caprifoliaceae
Weigela	Caprifoliaceae
Carica	Caricaceae
Jarilla	Caricaceae
Caryocar	Caryocaraceae
Achyronychia	Caryophyllaceae
Agrostemma	Caryophyllaceae
Alsinidendron	Caryophyllaceae
Arenaria	Caryophyllaceae
Cardionema	Caryophyllaceae
Cerastium	Caryophyllaceae
Corrigiola	Caryophyllaceae
Dianthus	Caryophyllaceae
Drymaria	Caryophyllaceae
Eremogone	Caryophyllaceae
Geocarpon	Caryophyllaceae
Gypsophila	Caryophyllaceae
Herniaria	Caryophyllaceae
Holosteum	Caryophyllaceae
Honckenya	Caryophyllaceae
Illecebrum	Caryophyllaceae
Lepyrodiclis	Caryophyllaceae
Loeflingia	Caryophyllaceae
Lychnis	Caryophyllaceae
Minuartia	Caryophyllaceae
Moehringia	Caryophyllaceae
Moenchia	Caryophyllaceae
Myosoton	Caryophyllaceae
Paronychia	Caryophyllaceae
Petrorhagia	Caryophyllaceae
Pollichia	Caryophyllaceae
Polycarpaea	Caryophyllaceae
Polycarpon	Caryophyllaceae
Pseudostellaria	Caryophyllaceae
Sagina	Caryophyllaceae
Saponaria	Caryophyllaceae
Schiedea	Caryophyllaceae
Scleranthus	Caryophyllaceae
Scopulophila	Caryophyllaceae
Silene	Caryophyllaceae
Spergula	Caryophyllaceae
Spergularia	Caryophyllaceae
Stellaria	Caryophyllaceae
Stipulicida	Caryophyllaceae
Vaccaria	Caryophyllaceae
Velezia	Caryophyllaceae
Wilhelmsia	Caryophyllaceae
Allocasuarina	Casuarinaceae
Casuarina	Casuarinaceae
Cecropia	Cecropiaceae
Canotia	Celastraceae
Cassine	Celastraceae
Catha	Celastraceae
Celastrus	Celastraceae
Crossopetalum	Celastraceae
Euonymus	Celastraceae
Gyminda	Celastraceae
Lophopyxis	Celastraceae
Maytenus	Celastraceae
Mortonia	Celastraceae
Paxistima	Celastraceae
Perrottetia	Celastraceae
Pristimera	Celastraceae
Salacia	Celastraceae
Schaefferia	Celastraceae
Torralbasia	Celastraceae
Ceratophyllum	Ceratophyllaceae
Cercidiphyllum	Cercidiphyllaceae
Allenrolfea	Chenopodiaceae
Aphanisma	Chenopodiaceae
Arthrocnemum	Chenopodiaceae
Atriplex	Chenopodiaceae
Axyris	Chenopodiaceae
Bassia	Chenopodiaceae
Beta	Chenopodiaceae
Camphorosma	Chenopodiaceae
Chenopodium	Chenopodiaceae
Corispermum	Chenopodiaceae
Cycloloma	Chenopodiaceae
Dysphania	Chenopodiaceae
Enchylaena	Chenopodiaceae
Endolepis	Chenopodiaceae
Exomis	Chenopodiaceae
Grayia	Chenopodiaceae
Halimione	Chenopodiaceae
Halocnemum	Chenopodiaceae
Halogeton	Chenopodiaceae
Kochia	Chenopodiaceae
Krascheninnikovia	Chenopodiaceae
Maireana	Chenopodiaceae
Microtea	Chenopodiaceae
Monolepis	Chenopodiaceae
Nitrophila	Chenopodiaceae
Polycnemum	Chenopodiaceae
Proatriplex	Chenopodiaceae
Salicornia	Chenopodiaceae
Salsola	Chenopodiaceae
Sarcobatus	Chenopodiaceae
Sarcocornia	Chenopodiaceae
Spinacia	Chenopodiaceae
Suaeda	Chenopodiaceae
Suckleya	Chenopodiaceae
Zuckia	Chenopodiaceae
Ascarina	Chloranthaceae
Hedyosmum	Chloranthaceae
Chrysobalanus	Chrysobalanaceae
Hirtella	Chrysobalanaceae
Licania	Chrysobalanaceae
Cistus	Cistaceae
Halimium	Cistaceae
Helianthemum	Cistaceae
Hudsonia	Cistaceae
Lechea	Cistaceae
Xolantha	Cistaceae
Clethra	Clethraceae
Calophyllum	Clusiaceae
Clusia	Clusiaceae
Garcinia	Clusiaceae
Hypericum	Clusiaceae
Mammea	Clusiaceae
Pentadesma	Clusiaceae
Platonia	Clusiaceae
Triadenum	Clusiaceae
Anogeissus	Combretaceae
Buchenavia	Combretaceae
Bucida	Combretaceae
Combretum	Combretaceae
Conocarpus	Combretaceae
Laguncularia	Combretaceae
Lumnitzera	Combretaceae
Quisqualis	Combretaceae
Terminalia	Combretaceae
Aneilema	Commelinaceae
Callisia	Commelinaceae
Commelina	Commelinaceae
Gibasis	Commelinaceae
Murdannia	Commelinaceae
Tinantia	Commelinaceae
Tradescantia	Commelinaceae
Tripogandra	Commelinaceae
Zebrina	Commelinaceae
Connarus	Connaraceae
Rourea	Connaraceae
Aniseia	Convolvulaceae
Argyreia	Convolvulaceae
Astripomoea	Convolvulaceae
Bonamia	Convolvulaceae
Calystegia	Convolvulaceae
Convolvulus	Convolvulaceae
Cressa	Convolvulaceae
Dichondra	Convolvulaceae
Evolvulus	Convolvulaceae
Ipomoea	Convolvulaceae
Jacquemontia	Convolvulaceae
Merremia	Convolvulaceae
Operculina	Convolvulaceae
Poranopsis	Convolvulaceae
Stictocardia	Convolvulaceae
Stylisma	Convolvulaceae
Turbina	Convolvulaceae
Xenostegia	Convolvulaceae
Aucuba	Cornaceae
Camptotheca	Cornaceae
Cornus	Cornaceae
Nyssa	Cornaceae
Corsinia	Corsiniaceae
Corynocarpus	Corynocarpaceae
Costus	Costaceae
Aeonium	Crassulaceae
Cotyledon	Crassulaceae
Crassula	Crassulaceae
Diamorpha	Crassulaceae
Dudleya	Crassulaceae
Echeveria	Crassulaceae
Graptopetalum	Crassulaceae
Hylotelephium	Crassulaceae
Jovibarba	Crassulaceae
Kalanchoe	Crassulaceae
Lenophyllum	Crassulaceae
Penthorum	Crassulaceae
Phedimus	Crassulaceae
Rhodiola	Crassulaceae
Sedella	Crassulaceae
Sedum	Crassulaceae
Sempervivum	Crassulaceae
Villadia	Crassulaceae
Apacheria	Crossosomataceae
Crossosoma	Crossosomataceae
Glossopetalon	Crossosomataceae
Apodanthera	Cucurbitaceae
Benincasa	Cucurbitaceae
Brandegea	Cucurbitaceae
Bryonia	Cucurbitaceae
Cayaponia	Cucurbitaceae
Citrullus	Cucurbitaceae
Coccinia	Cucurbitaceae
Ctenolepis	Cucurbitaceae
Cucumeropsis	Cucurbitaceae
Cucumis	Cucurbitaceae
Cucurbita	Cucurbitaceae
Cyclanthera	Cucurbitaceae
Doyerea	Cucurbitaceae
Ecballium	Cucurbitaceae
Echinocystis	Cucurbitaceae
Echinopepon	Cucurbitaceae
Fevillea	Cucurbitaceae
Hodgsonia	Cucurbitaceae
Ibervillea	Cucurbitaceae
Lagenaria	Cucurbitaceae
Luffa	Cucurbitaceae
Marah	Cucurbitaceae
Melothria	Cucurbitaceae
Momordica	Cucurbitaceae
Psiguria	Cucurbitaceae
Sechium	Cucurbitaceae
Sicana	Cucurbitaceae
Sicyos	Cucurbitaceae
Sicyosperma	Cucurbitaceae
Telfairia	Cucurbitaceae
Thladiantha	Cucurbitaceae
Trichosanthes	Cucurbitaceae
Tumamoca	Cucurbitaceae
Zehneria	Cucurbitaceae
Eucryphia	Cunoniaceae
Weinmannia	Cunoniaceae
Austrocedrus	Cupressaceae
Callitris	Cupressaceae
Calocedrus	Cupressaceae
Chamaecyparis	Cupressaceae
Cryptomeria	Cupressaceae
Cunninghamia	Cupressaceae
Cupressocyparis	Cupressaceae
Cupressus	Cupressaceae
Fitzroya	Cupressaceae
Juniperus	Cupressaceae
Metasequoia	Cupressaceae
Platycladus	Cupressaceae
Sequoia	Cupressaceae
Sequoiadendron	Cupressaceae
Taxodium	Cupressaceae
Tetraclinis	Cupressaceae
Thuja	Cupressaceae
Cuscuta	Cuscutaceae
Alsophila	Cyatheaceae
Cnemidaria	Cyatheaceae
Cyathea	Cyatheaceae
Nephelea	Cyatheaceae
Trichipteris	Cyatheaceae
Cycas	Cycadaceae
Carludovica	Cyclanthaceae
Cymodocea	Cymodoceaceae
Halodule	Cymodoceaceae
Syringodium	Cymodoceaceae
Thalassodendron	Cymodoceaceae
Abildgaardia	Cyperaceae
Blysmus	Cyperaceae
Bulbostylis	Cyperaceae
Carex	Cyperaceae
Cladium	Cyperaceae
Cymophyllus	Cyperaceae
Cyperus	Cyperaceae
Dulichium	Cyperaceae
Eleocharis	Cyperaceae
Eriophorum	Cyperaceae
Fimbristylis	Cyperaceae
Fuirena	Cyperaceae
Gahnia	Cyperaceae
Hypolytrum	Cyperaceae
Isolepis	Cyperaceae
Kobresia	Cyperaceae
Kyllinga	Cyperaceae
Lagenocarpus	Cyperaceae
Lepironia	Cyperaceae
Lipocarpha	Cyperaceae
Machaerina	Cyperaceae
Mapania	Cyperaceae
Morelotia	Cyperaceae
Oreobolus	Cyperaceae
Oxycaryum	Cyperaceae
Remirea	Cyperaceae
Rhynchospora	Cyperaceae
Schoenoplectus	Cyperaceae
Schoenus	Cyperaceae
Scirpodendron	Cyperaceae
Scirpoides	Cyperaceae
Scirpus	Cyperaceae
Scleria	Cyperaceae
Trichophorum	Cyperaceae
Uncinia	Cyperaceae
Websteria	Cyperaceae
Cliftonia	Cyrillaceae
Cyrilla	Cyrillaceae
Datisca	Datiscaceae
Davallia	Davalliaceae
Dennstaedtia	Dennstaedtiaceae
Histiopteris	Dennstaedtiaceae
Hypolepis	Dennstaedtiaceae
Lindsaea	Dennstaedtiaceae
Lindsaeosoria	Dennstaedtiaceae
Lonchitis	Dennstaedtiaceae
Microlepia	Dennstaedtiaceae
Odontosoria	Dennstaedtiaceae
Pteridium	Dennstaedtiaceae
Saccoloma	Dennstaedtiaceae
Diapensia	Diapensiaceae
Galax	Diapensiaceae
Pyxidanthera	Diapensiaceae
Shortia	Diapensiaceae
Cibotium	Dicksoniaceae
Dicksonia	Dicksoniaceae
Dillenia	Dilleniaceae
Doliocarpus	Dilleniaceae
Pinzona	Dilleniaceae
Dioscorea	Dioscoreaceae
Rajania	Dioscoreaceae
Cephalaria	Dipsacaceae
Dipsacus	Dipsacaceae
Knautia	Dipsacaceae
Scabiosa	Dipsacaceae
Succisa	Dipsacaceae
Succisella	Dipsacaceae
Dryobalanops	Dipterocarpaceae
Hopea	Dipterocarpaceae
Shorea	Dipterocarpaceae
Vateria	Dipterocarpaceae
Dionaea	Droseraceae
Drosera	Droseraceae
Arachniodes	Dryopteridaceae
Athyrium	Dryopteridaceae
Bolbitis	Dryopteridaceae
Ctenitis	Dryopteridaceae
Cyclopeltis	Dryopteridaceae
Cyrtomium	Dryopteridaceae
Cystopteris	Dryopteridaceae
Deparia	Dryopteridaceae
Diplazium	Dryopteridaceae
Dryopteris	Dryopteridaceae
Elaphoglossum	Dryopteridaceae
Fadyenia	Dryopteridaceae
Gymnocarpium	Dryopteridaceae
Hemidictyum	Dryopteridaceae
Heterogonium	Dryopteridaceae
Hypoderris	Dryopteridaceae
Lastreopsis	Dryopteridaceae
Lomagramma	Dryopteridaceae
Lomariopsis	Dryopteridaceae
Matteuccia	Dryopteridaceae
Maxonia	Dryopteridaceae
Megalastrum	Dryopteridaceae
Nephrolepis	Dryopteridaceae
Nothoperanema	Dryopteridaceae
Oleandra	Dryopteridaceae
Olfersia	Dryopteridaceae
Onoclea	Dryopteridaceae
Phanerophlebia	Dryopteridaceae
Polystichum	Dryopteridaceae
Rumohra	Dryopteridaceae
Tectaria	Dryopteridaceae
Triplophyllum	Dryopteridaceae
Woodsia	Dryopteridaceae
Diospyros	Ebenaceae
Elaeagnus	Elaeagnaceae
Hippophae	Elaeagnaceae
Shepherdia	Elaeagnaceae
Aristotelia	Elaeocarpaceae
Elaeocarpus	Elaeocarpaceae
Muntingia	Elaeocarpaceae
Sloanea	Elaeocarpaceae
Bergia	Elatinaceae
Elatine	Elatinaceae
Ceratiola	Empetraceae
Corema	Empetraceae
Empetrum	Empetraceae
Leucopogon	Epacridaceae
Styphelia	Epacridaceae
Ephedra	Ephedraceae
Equisetum	Equisetaceae
Antidaphne	Eremolepidaceae
Eubrachion	Eremolepidaceae
Agarista	Ericaceae
Andromeda	Ericaceae
Arbutus	Ericaceae
Arctostaphylos	Ericaceae
Befaria	Ericaceae
Bejaria	Ericaceae
Calluna	Ericaceae
Cassiope	Ericaceae
Chamaedaphne	Ericaceae
Comarostaphylis	Ericaceae
Elliottia	Ericaceae
Enkianthus	Ericaceae
Epigaea	Ericaceae
Erica	Ericaceae
Eubotrys	Ericaceae
Gaultheria	Ericaceae
Gaylussacia	Ericaceae
Gonocalyx	Ericaceae
Harrimanella	Ericaceae
Kalmia	Ericaceae
Kalmiopsis	Ericaceae
Ledum	Ericaceae
Leiophyllum	Ericaceae
Leucothoe	Ericaceae
Loiseleuria	Ericaceae
Lyonia	Ericaceae
Menziesia	Ericaceae
Ornithostaphylos	Ericaceae
Oxydendrum	Ericaceae
Phyllodoce	Ericaceae
Pieris	Ericaceae
Rhododendron	Ericaceae
Symphysia	Ericaceae
Vaccinium	Ericaceae
Xylococcus	Ericaceae
Zenobia	Ericaceae
Eriocaulon	Eriocaulaceae
Lachnocaulon	Eriocaulaceae
Syngonanthus	Eriocaulaceae
Erythroxylum	Erythroxylaceae
Acalypha	Euphorbiaceae
Adelia	Euphorbiaceae
Alchornea	Euphorbiaceae
Alchorneopsis	Euphorbiaceae
Aleurites	Euphorbiaceae
Antidesma	Euphorbiaceae
Argythamnia	Euphorbiaceae
Baccaurea	Euphorbiaceae
Bernardia	Euphorbiaceae
Bischofia	Euphorbiaceae
Breynia	Euphorbiaceae
Caperonia	Euphorbiaceae
Chamaesyce	Euphorbiaceae
Chrozophora	Euphorbiaceae
Claoxylon	Euphorbiaceae
Cnidoscolus	Euphorbiaceae
Codiaeum	Euphorbiaceae
Croton	Euphorbiaceae
Dalechampia	Euphorbiaceae
Ditrysinia	Euphorbiaceae
Ditta	Euphorbiaceae
Drypetes	Euphorbiaceae
Euphorbia	Euphorbiaceae
Excoecaria	Euphorbiaceae
Flueggea	Euphorbiaceae
Garcia	Euphorbiaceae
Glochidion	Euphorbiaceae
Gymnanthes	Euphorbiaceae
Hevea	Euphorbiaceae
Hippomane	Euphorbiaceae
Hura	Euphorbiaceae
Hyeronima	Euphorbiaceae
Jatropha	Euphorbiaceae
Leptopus	Euphorbiaceae
Macaranga	Euphorbiaceae
Mallotus	Euphorbiaceae
Manihot	Euphorbiaceae
Margaritaria	Euphorbiaceae
Melanolepis	Euphorbiaceae
Mercurialis	Euphorbiaceae
Micrandra	Euphorbiaceae
Microstachys	Euphorbiaceae
Pedilanthus	Euphorbiaceae
Pera	Euphorbiaceae
Phyllanthus	Euphorbiaceae
Reutealis	Euphorbiaceae
Reverchonia	Euphorbiaceae
Ricinodendron	Euphorbiaceae
Ricinus	Euphorbiaceae
Sapium	Euphorbiaceae
Sauropus	Euphorbiaceae
Savia	Euphorbiaceae
Sebastiania	Euphorbiaceae
Stillingia	Euphorbiaceae
Tetracarpidium	Euphorbiaceae
Tetracoccus	Euphorbiaceae
Tragia	Euphorbiaceae
Triadica	Euphorbiaceae
Vaupesia	Euphorbiaceae
Vernicia	Euphorbiaceae
Abrus	Fabaceae
Acacia	Fabaceae
Adenanthera	Fabaceae
Adenocarpus	Fabaceae
Adesmia	Fabaceae
Aeschynomene	Fabaceae
Afzelia	Fabaceae
Albizia	Fabaceae
Alhagi	Fabaceae
Alysicarpus	Fabaceae
Amorpha	Fabaceae
Amphicarpaea	Fabaceae
Anadenanthera	Fabaceae
Andira	Fabaceae
Anthyllis	Fabaceae
Antopetitia	Fabaceae
Apios	Fabaceae
Arachis	Fabaceae
Argyrolobium	Fabaceae
Aspalathus	Fabaceae
Astragalus	Fabaceae
Baphia	Fabaceae
Baptisia	Fabaceae
Barbieria	Fabaceae
Bauhinia	Fabaceae
Biserrula	Fabaceae
Bituminaria	Fabaceae
Bossiaea	Fabaceae
Brongniartia	Fabaceae
Brya	Fabaceae
Butea	Fabaceae
Caesalpinia	Fabaceae
Cajanus	Fabaceae
Calliandra	Fabaceae
Calophaca	Fabaceae
Calopogonium	Fabaceae
Canavalia	Fabaceae
Caragana	Fabaceae
Carmichaelia	Fabaceae
Cassia	Fabaceae
Centrosema	Fabaceae
Ceratonia	Fabaceae
Cercis	Fabaceae
Chamaecrista	Fabaceae
Chamaecytisus	Fabaceae
Chapmannia	Fabaceae
Christia	Fabaceae
Cicer	Fabaceae
Cladrastis	Fabaceae
Clianthus	Fabaceae
Clitoria	Fabaceae
Codariocalyx	Fabaceae
Cojoba	Fabaceae
Cologania	Fabaceae
Colophospermum	Fabaceae
Colutea	Fabaceae
Copaifera	Fabaceae
Cordyla	Fabaceae
Coronilla	Fabaceae
Coursetia	Fabaceae
Crotalaria	Fabaceae
Crudia	Fabaceae
Cullen	Fabaceae
Cyamopsis	Fabaceae
Cynometra	Fabaceae
Cytisophyllum	Fabaceae
Cytisus	Fabaceae
Dalbergia	Fabaceae
Dalea	Fabaceae
Daniellia	Fabaceae
Delonix	Fabaceae
Dendrolobium	Fabaceae
Derris	Fabaceae
Desmanthus	Fabaceae
Desmodium	Fabaceae
Dialium	Fabaceae
Dichrostachys	Fabaceae
Dillwynia	Fabaceae
Dioclea	Fabaceae
Diphysa	Fabaceae
Dipogon	Fabaceae
Dipteryx	Fabaceae
Dolichos	Fabaceae
Dorycnium	Fabaceae
Ebenopsis	Fabaceae
Ebenus	Fabaceae
Entada	Fabaceae
Enterolobium	Fabaceae
Eriosema	Fabaceae
Errazurizia	Fabaceae
Erythrina	Fabaceae
Erythrophleum	Fabaceae
Eysenhardtia	Fabaceae
Faidherbia	Fabaceae
Falcataria	Fabaceae
Flemingia	Fabaceae
Galactia	Fabaceae
Galega	Fabaceae
Genista	Fabaceae
Genistidium	Fabaceae
Geoffroea	Fabaceae
Gleditsia	Fabaceae
Gliricidia	Fabaceae
Glycine	Fabaceae
Glycyrrhiza	Fabaceae
Guibourtia	Fabaceae
Gymnocladus	Fabaceae
Haematoxylum	Fabaceae
Halimodendron	Fabaceae
Hardenbergia	Fabaceae
Havardia	Fabaceae
Hebestigma	Fabaceae
Hedysarum	Fabaceae
Hippocrepis	Fabaceae
Hoffmannseggia	Fabaceae
Hoita	Fabaceae
Hymenaea	Fabaceae
Hymenocarpos	Fabaceae
Indigofera	Fabaceae
Inga	Fabaceae
Inocarpus	Fabaceae
Intsia	Fabaceae
Kanaloa	Fabaceae
Kennedia	Fabaceae
Kummerowia	Fabaceae
Lablab	Fabaceae
Laburnum	Fabaceae
Lathyrus	Fabaceae
Lebeckia	Fabaceae
Lens	Fabaceae
Lespedeza	Fabaceae
Lessertia	Fabaceae
Leucaena	Fabaceae
Lonchocarpus	Fabaceae
Lotononis	Fabaceae
Lotus	Fabaceae
Lupinus	Fabaceae
Lysiloma	Fabaceae
Maackia	Fabaceae
Machaerium	Fabaceae
Macroptilium	Fabaceae
Macrotyloma	Fabaceae
Marina	Fabaceae
Medicago	Fabaceae
Melilotus	Fabaceae
Melolobium	Fabaceae
Millettia	Fabaceae
Mimosa	Fabaceae
Mucuna	Fabaceae
Myrospermum	Fabaceae
Myroxylon	Fabaceae
Neonotonia	Fabaceae
Neorudolphia	Fabaceae
Neptunia	Fabaceae
Nissolia	Fabaceae
Olneya	Fabaceae
Onobrychis	Fabaceae
Ononis	Fabaceae
Orbexilum	Fabaceae
Ormosia	Fabaceae
Ornithopus	Fabaceae
Otholobium	Fabaceae
Oxylobium	Fabaceae
Oxyrhynchus	Fabaceae
Oxytropis	Fabaceae
Pachyrhizus	Fabaceae
Paraserianthes	Fabaceae
Parkia	Fabaceae
Parkinsonia	Fabaceae
Parochetus	Fabaceae
Parryella	Fabaceae
Pediomelum	Fabaceae
Peltophorum	Fabaceae
Pentaclethra	Fabaceae
Periandra	Fabaceae
Pericopsis	Fabaceae
Peteria	Fabaceae
Phaseolus	Fabaceae
Physostigma	Fabaceae
Pickeringia	Fabaceae
Pictetia	Fabaceae
Piscidia	Fabaceae
Pisum	Fabaceae
Pithecellobium	Fabaceae
Poitea	Fabaceae
Pomaria	Fabaceae
Prosopis	Fabaceae
Pseudarthria	Fabaceae
Psophocarpus	Fabaceae
Psoralidium	Fabaceae
Psorothamnus	Fabaceae
Pterocarpus	Fabaceae
Pueraria	Fabaceae
Retama	Fabaceae
Rhynchosia	Fabaceae
Robinia	Fabaceae
Rupertia	Fabaceae
Samanea	Fabaceae
Schizolobium	Fabaceae
Schleinitzia	Fabaceae
Scorpiurus	Fabaceae
Securigera	Fabaceae
Senna	Fabaceae
Serianthes	Fabaceae
Sesbania	Fabaceae
Sophora	Fabaceae
Spartium	Fabaceae
Sphaerophysa	Fabaceae
Sphenostylis	Fabaceae
Sphinctospermum	Fabaceae
Stahlia	Fabaceae
Strongylodon	Fabaceae
Strophostyles	Fabaceae
Stryphnodendron	Fabaceae
Stylosanthes	Fabaceae
Styphnolobium	Fabaceae
Sutherlandia	Fabaceae
Tamarindus	Fabaceae
Taralea	Fabaceae
Tephrosia	Fabaceae
Teramnus	Fabaceae
Tetragonolobus	Fabaceae
Thermopsis	Fabaceae
Ticanto	Fabaceae
Tipuana	Fabaceae
Trifolium	Fabaceae
Trigonella	Fabaceae
Tripodion	Fabaceae
Ulex	Fabaceae
Vicia	Fabaceae
Vigna	Fabaceae
Virgilia	Fabaceae
Wiborgia	Fabaceae
Wisteria	Fabaceae
Zapoteca	Fabaceae
Zornia	Fabaceae
Castanea	Fagaceae
Castanopsis	Fagaceae
Chrysolepis	Fagaceae
Fagus	Fagaceae
Lithocarpus	Fagaceae
Quercus	Fagaceae
Banara	Flacourtiaceae
Caloncoba	Flacourtiaceae
Casearia	Flacourtiaceae
Dovyalis	Flacourtiaceae
Flacourtia	Flacourtiaceae
Homalium	Flacourtiaceae
Hydnocarpus	Flacourtiaceae
Laetia	Flacourtiaceae
Lunania	Flacourtiaceae
Oncoba	Flacourtiaceae
Pangium	Flacourtiaceae
Prockia	Flacourtiaceae
Samyda	Flacourtiaceae
Xylosma	Flacourtiaceae
Flagellaria	Flagellariaceae
Fouquieria	Fouquieriaceae
Frankenia	Frankeniaceae
Adlumia	Fumariaceae
Corydalis	Fumariaceae
Dicentra	Fumariaceae
Ehrendorferia	Fumariaceae
Fumaria	Fumariaceae
Hypecoum	Fumariaceae
Lamprocapnos	Fumariaceae
Pseudofumaria	Fumariaceae
Garrya	Garryaceae
Bartonia	Gentianaceae
Centaurium	Gentianaceae
Cicendia	Gentianaceae
Enicostema	Gentianaceae
Eustoma	Gentianaceae
Frasera	Gentianaceae
Gentiana	Gentianaceae
Gentianella	Gentianaceae
Gentianopsis	Gentianaceae
Halenia	Gentianaceae
Lisianthius	Gentianaceae
Lomatogonium	Gentianaceae
Obolaria	Gentianaceae
Sabatia	Gentianaceae
Schultesia	Gentianaceae
Swertia	Gentianaceae
Voyria	Gentianaceae
Erodium	Geraniaceae
Geranium	Geraniaceae
Pelargonium	Geraniaceae
Chrysothemis	Gesneriaceae
Columnea	Gesneriaceae
Cyrtandra	Gesneriaceae
Episcia	Gesneriaceae
Gesneria	Gesneriaceae
Gloxinia	Gesneriaceae
Kohleria	Gesneriaceae
Rhytidophyllum	Gesneriaceae
Saintpaulia	Gesneriaceae
Sarmienta	Gesneriaceae
Sinningia	Gesneriaceae
Streptocarpus	Gesneriaceae
Ginkgo	Ginkgoaceae
Dicranopteris	Gleicheniaceae
Diplopterygium	Gleicheniaceae
Gleichenia	Gleicheniaceae
Sticherus	Gleicheniaceae
Gnetum	Gnetaceae
Scaevola	Goodeniaceae
Greyia	Greyiaceae
Escallonia	Grossulariaceae
Itea	Grossulariaceae
Ribes	Grossulariaceae
Gunnera	Gunneraceae
Lachnanthes	Haemodoraceae
Wachendorfia	Haemodoraceae
Xiphidium	Haemodoraceae
Gonocarpus	Haloragaceae
Haloragis	Haloragaceae
Myriophyllum	Haloragaceae
Proserpinaca	Haloragaceae
Corylopsis	Hamamelidaceae
Fothergilla	Hamamelidaceae
Hamamelis	Hamamelidaceae
Liquidambar	Hamamelidaceae
Parrotia	Hamamelidaceae
Hanguana	Hanguanaceae
Heliconia	Heliconiaceae
Hernandia	Hernandiaceae
Aesculus	Hippocastanaceae
Hippocratea	Hippocrateaceae
Hippuris	Hippuridaceae
Broussaisia	Hydrangeaceae
Carpenteria	Hydrangeaceae
Decumaria	Hydrangeaceae
Deutzia	Hydrangeaceae
Fendlera	Hydrangeaceae
Fendlerella	Hydrangeaceae
Hydrangea	Hydrangeaceae
Jamesia	Hydrangeaceae
Philadelphus	Hydrangeaceae
Schizophragma	Hydrangeaceae
Whipplea	Hydrangeaceae
Blyxa	Hydrocharitaceae
Egeria	Hydrocharitaceae
Elodea	Hydrocharitaceae
Enhalus	Hydrocharitaceae
Halophila	Hydrocharitaceae
Hydrilla	Hydrocharitaceae
Hydrocharis	Hydrocharitaceae
Lagarosiphon	Hydrocharitaceae
Limnobium	Hydrocharitaceae
Nechamandra	Hydrocharitaceae
Ottelia	Hydrocharitaceae
Stratiotes	Hydrocharitaceae
Thalassia	Hydrocharitaceae
Vallisneria	Hydrocharitaceae
Draperia	Hydrophyllaceae
Ellisia	Hydrophyllaceae
Emmenanthe	Hydrophyllaceae
Eriodictyon	Hydrophyllaceae
Eucrypta	Hydrophyllaceae
Hesperochiron	Hydrophyllaceae
Hydrolea	Hydrophyllaceae
Hydrophyllum	Hydrophyllaceae
Nama	Hydrophyllaceae
Nemophila	Hydrophyllaceae
Phacelia	Hydrophyllaceae
Pholistoma	Hydrophyllaceae
Romanzoffia	Hydrophyllaceae
Tricardia	Hydrophyllaceae
Turricula	Hydrophyllaceae
Wigandia	Hydrophyllaceae
Hymenophyllum	Hymenophyllaceae
Trichomanes	Hymenophyllaceae
Vandenboschia	Hymenophyllaceae
Icacina	Icacinaceae
Mappia	Icacinaceae
Merrilliodendron	Icacinaceae
Ottoschulzia	Icacinaceae
Stemonurus	Icacinaceae
Illicium	Illiciaceae
Acidanthera	Iridaceae
Alophia	Iridaceae
Aristea	Iridaceae
Belamcanda	Iridaceae
Calydorea	Iridaceae
Chasmanthe	Iridaceae
Crocosmia	Iridaceae
Crocus	Iridaceae
Dietes	Iridaceae
Eleutherine	Iridaceae
Freesia	Iridaceae
Gladiolus	Iridaceae
Herbertia	Iridaceae
Homeria	Iridaceae
Iris	Iridaceae
Ixia	Iridaceae
Libertia	Iridaceae
Moraea	Iridaceae
Nemastylis	Iridaceae
Neomarica	Iridaceae
Olsynium	Iridaceae
Pardanthopsis	Iridaceae
Romulea	Iridaceae
Schizostylis	Iridaceae
Sisyrinchium	Iridaceae
Sparaxis	Iridaceae
Tigridia	Iridaceae
Trimezia	Iridaceae
Watsonia	Iridaceae
Isoetes	Isoetaceae
Joinvillea	Joinvilleaceae
Carya	Juglandaceae
Juglans	Juglandaceae
Platycarya	Juglandaceae
Pterocarya	Juglandaceae
Juncus	Juncaceae
Luzula	Juncaceae
Lilaea	Juncaginaceae
Triglochin	Juncaginaceae
Krameria	Krameriaceae
Acanthomintha	Lamiaceae
Acinos	Lamiaceae
Agastache	Lamiaceae
Ajuga	Lamiaceae
Ballota	Lamiaceae
Blephilia	Lamiaceae
Brazoria	Lamiaceae
Calamintha	Lamiaceae
Cedronella	Lamiaceae
Chaiturus	Lamiaceae
Clinopodium	Lamiaceae
Coleus	Lamiaceae
Collinsonia	Lamiaceae
Conradina	Lamiaceae
Cunila	Lamiaceae
Dicerandra	Lamiaceae
Dracocephalum	Lamiaceae
Elsholtzia	Lamiaceae
Erythrochlamys	Lamiaceae
Galeopsis	Lamiaceae
Glechoma	Lamiaceae
Haplostachys	Lamiaceae
Hedeoma	Lamiaceae
Hyptis	Lamiaceae
Hyssopus	Lamiaceae
Lallemantia	Lamiaceae
Lamiastrum	Lamiaceae
Lamium	Lamiaceae
Lavandula	Lamiaceae
Leonotis	Lamiaceae
Leonurus	Lamiaceae
Lepechinia	Lamiaceae
Leucas	Lamiaceae
Lycopus	Lamiaceae
Macbridea	Lamiaceae
Marrubium	Lamiaceae
Marsypianthes	Lamiaceae
Meehania	Lamiaceae
Melissa	Lamiaceae
Mentha	Lamiaceae
Moluccella	Lamiaceae
Monarda	Lamiaceae
Monardella	Lamiaceae
Mosla	Lamiaceae
Nepeta	Lamiaceae
Ocimum	Lamiaceae
Origanum	Lamiaceae
Orthosiphon	Lamiaceae
Perilla	Lamiaceae
Perovskia	Lamiaceae
Phlomis	Lamiaceae
Phyllostegia	Lamiaceae
Physostegia	Lamiaceae
Piloblephis	Lamiaceae
Plectranthus	Lamiaceae
Pogogyne	Lamiaceae
Pogostemon	Lamiaceae
Poliomintha	Lamiaceae
Prunella	Lamiaceae
Pycnanthemum	Lamiaceae
Rhododon	Lamiaceae
Rosmarinus	Lamiaceae
Salazaria	Lamiaceae
Salvia	Lamiaceae
Satureja	Lamiaceae
Scutellaria	Lamiaceae
Sideritis	Lamiaceae
Solenostemon	Lamiaceae
Stachydeoma	Lamiaceae
Stachys	Lamiaceae
Stenogyne	Lamiaceae
Synandra	Lamiaceae
Teucrium	Lamiaceae
Thymus	Lamiaceae
Trichostema	Lamiaceae
Warnockia	Lamiaceae
Akebia	Lardizabalaceae
Aniba	Lauraceae
Beilschmiedia	Lauraceae
Cassytha	Lauraceae
Cinnamomum	Lauraceae
Cryptocarya	Lauraceae
Endiandra	Lauraceae
Eusideroxylon	Lauraceae
Laurus	Lauraceae
Licaria	Lauraceae
Lindera	Lauraceae
Litsea	Lauraceae
Nectandra	Lauraceae
Ocotea	Lauraceae
Persea	Lauraceae
Sassafras	Lauraceae
Umbellularia	Lauraceae
Barringtonia	Lecythidaceae
Bertholletia	Lecythidaceae
Couroupita	Lecythidaceae
Lecythis	Lecythidaceae
Leitneria	Leitneriaceae
Landoltia	Lemnaceae
Lemna	Lemnaceae
Spirodela	Lemnaceae
Wolffia	Lemnaceae
Wolffiella	Lemnaceae
Pholisma	Lennoaceae
Pinguicula	Lentibulariaceae
Utricularia	Lentibulariaceae
Agapanthus	Liliaceae
Aletris	Liliaceae
Allium	Liliaceae
Alstroemeria	Liliaceae
Amaryllis	Liliaceae
Amianthium	Liliaceae
Ammocharis	Liliaceae
Androstephium	Liliaceae
Arthropodium	Liliaceae
Asparagus	Liliaceae
Asphodelus	Liliaceae
Astelia	Liliaceae
Beaucarnea	Liliaceae
Bloomeria	Liliaceae
Bomarea	Liliaceae
Brodiaea	Liliaceae
Calochortus	Liliaceae
Camassia	Liliaceae
Chamaelirium	Liliaceae
Chionodoxa	Liliaceae
Chlorogalum	Liliaceae
Chlorophytum	Liliaceae
Clintonia	Liliaceae
Clivia	Liliaceae
Colchicum	Liliaceae
Convallaria	Liliaceae
Cooperia	Liliaceae
Cordyline	Liliaceae
Crinum	Liliaceae
Curculigo	Liliaceae
Dasylirion	Liliaceae
Dianella	Liliaceae
Dichelostemma	Liliaceae
Echeandia	Liliaceae
Eremocrinum	Liliaceae
Erythronium	Liliaceae
Eucharis	Liliaceae
Eurycles	Liliaceae
Fritillaria	Liliaceae
Gagea	Liliaceae
Galanthus	Liliaceae
Gloriosa	Liliaceae
Habranthus	Liliaceae
Harperocallis	Liliaceae
Hastingsia	Liliaceae
Helonias	Liliaceae
Hemerocallis	Liliaceae
Hesperocallis	Liliaceae
Hippeastrum	Liliaceae
Hosta	Liliaceae
Hyacinthoides	Liliaceae
Hyacinthus	Liliaceae
Hymenocallis	Liliaceae
Hypoxis	Liliaceae
Kniphofia	Liliaceae
Lachenalia	Liliaceae
Leucocrinum	Liliaceae
Leucojum	Liliaceae
Lilium	Liliaceae
Liriope	Liliaceae
Lloydia	Liliaceae
Lophiola	Liliaceae
Lycoris	Liliaceae
Maianthemum	Liliaceae
Medeola	Liliaceae
Milla	Liliaceae
Muilla	Liliaceae
Muscari	Liliaceae
Narcissus	Liliaceae
Narthecium	Liliaceae
Nerine	Liliaceae
Nolina	Liliaceae
Nothoscordum	Liliaceae
Odontostomum	Liliaceae
Oncostema	Liliaceae
Ophiopogon	Liliaceae
Ornithogalum	Liliaceae
Pancratium	Liliaceae
Pleea	Liliaceae
Pleomele	Liliaceae
Polygonatum	Liliaceae
Prosartes	Liliaceae
Scadoxus	Liliaceae
Schoenocaulon	Liliaceae
Schoenolirion	Liliaceae
Scilla	Liliaceae
Scoliopus	Liliaceae
Sprekelia	Liliaceae
Stenanthium	Liliaceae
Stenomesson	Liliaceae
Sternbergia	Liliaceae
Streptopus	Liliaceae
Tofieldia	Liliaceae
Triantha	Liliaceae
Tricyrtis	Liliaceae
Trillium	Liliaceae
Tristagma	Liliaceae
Triteleia	Liliaceae
Triteleiopsis	Liliaceae
Tulbaghia	Liliaceae
Tulipa	Liliaceae
Urginea	Liliaceae
Uvularia	Liliaceae
Veratrum	Liliaceae
Xerophyllum	Liliaceae
Zephyranthes	Liliaceae
Zigadenus	Liliaceae
Floerkea	Limnanthaceae
Limnanthes	Limnanthaceae
Hydrocleys	Limnocharitaceae
Limnocharis	Limnocharitaceae
Hesperolinon	Linaceae
Linum	Linaceae
Radiola	Linaceae
Sclerolinon	Linaceae
Cevallia	Loasaceae
Eucnide	Loasaceae
Mentzelia	Loasaceae
Petalonyx	Loasaceae
Desfontainia	Loganiaceae
Fagraea	Loganiaceae
Gelsemium	Loganiaceae
Geniostoma	Loganiaceae
Labordia	Loganiaceae
Mitreola	Loganiaceae
Neuburgia	Loganiaceae
Spigelia	Loganiaceae
Strychnos	Loganiaceae
Lophosoria	Lophosoriaceae
Dendropemon	Loranthaceae
Dendrophthora	Loranthaceae
Huperzia	Lycopodiaceae
Lycopodiella	Lycopodiaceae
Lycopodium	Lycopodiaceae
Lygodium	Lygodiaceae
Ammannia	Lythraceae
Cuphea	Lythraceae
Decodon	Lythraceae
Didiplis	Lythraceae
Ginoria	Lythraceae
Heimia	Lythraceae
Lagerstroemia	Lythraceae
Lawsonia	Lythraceae
Lythrum	Lythraceae
Nesaea	Lythraceae
Pemphis	Lythraceae
Rotala	Lythraceae
Liriodendron	Magnoliaceae
Magnolia	Magnoliaceae
Michelia	Magnoliaceae
Parakmeria	Magnoliaceae
Aspicarpa	Malpighiaceae
Banisteriopsis	Malpighiaceae
Bunchosia	Malpighiaceae
Byrsonima	Malpighiaceae
Callaeum	Malpighiaceae
Galphimia	Malpighiaceae
Heteropteris	Malpighiaceae
Heteropterys	Malpighiaceae
Hiptage	Malpighiaceae
Hiraea	Malpighiaceae
Janusia	Malpighiaceae
Malpighia	Malpighiaceae
Stigmaphyllon	Malpighiaceae
Tetrapterys	Malpighiaceae
Tristellateia	Malpighiaceae
Abelmoschus	Malvaceae
Abutilon	Malvaceae
Alcea	Malvaceae
Allosidastrum	Malvaceae
Allowissadula	Malvaceae
Althaea	Malvaceae
Anisodontea	Malvaceae
Anoda	Malvaceae
Bastardia	Malvaceae
Bastardiopsis	Malvaceae
Batesimalva	Malvaceae
Billieturnera	Malvaceae
Callirhoe	Malvaceae
Cienfuegosia	Malvaceae
Eremalche	Malvaceae
Fioria	Malvaceae
Fryxellia	Malvaceae
Gossypium	Malvaceae
Herissantia	Malvaceae
Hibiscadelphus	Malvaceae
Hibiscus	Malvaceae
Hoheria	Malvaceae
Horsfordia	Malvaceae
Iliamna	Malvaceae
Kokia	Malvaceae
Kosteletzkya	Malvaceae
Krapovickasia	Malvaceae
Lagunaria	Malvaceae
Lavatera	Malvaceae
Malachra	Malvaceae
Malacothamnus	Malvaceae
Malva	Malvaceae
Malvastrum	Malvaceae
Malvaviscus	Malvaceae
Malvella	Malvaceae
Meximalva	Malvaceae
Modiola	Malvaceae
Napaea	Malvaceae
Pavonia	Malvaceae
Phymosia	Malvaceae
Pseudabutilon	Malvaceae
Rhynchosida	Malvaceae
Sida	Malvaceae
Sidalcea	Malvaceae
Sidastrum	Malvaceae
Sphaeralcea	Malvaceae
Thespesia	Malvaceae
Urena	Malvaceae
Wissadula	Malvaceae
Calathea	Marantaceae
Donax	Marantaceae
Maranta	Marantaceae
Marantochloa	Marantaceae
Myrosma	Marantaceae
Thalia	Marantaceae
Thaumatococcus	Marantaceae
Angiopteris	Marattiaceae
Danaea	Marattiaceae
Marattia	Marattiaceae
Marcgravia	Marcgraviaceae
Marsilea	Marsileaceae
Pilularia	Marsileaceae
Regnellidium	Marsileaceae
Mayaca	Mayacaceae
Acisanthera	Melastomataceae
Arthrostemma	Melastomataceae
Astronidium	Melastomataceae
Clidemia	Melastomataceae
Conostegia	Melastomataceae
Dissotis	Melastomataceae
Graffenrieda	Melastomataceae
Henriettea	Melastomataceae
Heterocentron	Melastomataceae
Leandra	Melastomataceae
Mecranium	Melastomataceae
Medinilla	Melastomataceae
Melastoma	Melastomataceae
Miconia	Melastomataceae
Mouriri	Melastomataceae
Nepsera	Melastomataceae
Oxyspora	Melastomataceae
Pterolepis	Melastomataceae
Rhexia	Melastomataceae
Sagraea	Melastomataceae
Tetrazygia	Melastomataceae
Tibouchina	Melastomataceae
Trembleya	Melastomataceae
Aglaia	Meliaceae
Aphanamixis	Meliaceae
Azadirachta	Meliaceae
Carapa	Meliaceae
Cedrela	Meliaceae
Dysoxylum	Meliaceae
Entandrophragma	Meliaceae
Guarea	Meliaceae
Khaya	Meliaceae
Lansium	Meliaceae
Melia	Meliaceae
Sandoricum	Meliaceae
Swietenia	Meliaceae
Toona	Meliaceae
Trichilia	Meliaceae
Xylocarpus	Meliaceae
Melianthus	Melianthaceae
Calycocarpum	Menispermaceae
Chondrodendron	Menispermaceae
Cissampelos	Menispermaceae
Cocculus	Menispermaceae
Dioscoreophyllum	Menispermaceae
Fibraurea	Menispermaceae
Hyperbaena	Menispermaceae
Jateorhiza	Menispermaceae
Menispermum	Menispermaceae
Menyanthes	Menyanthaceae
Nephrophyllidium	Menyanthaceae
Nymphoides	Menyanthaceae
Glinus	Molluginaceae
Mollugo	Molluginaceae
Peumus	Monimiaceae
Allotropa	Monotropaceae
Hemitomes	Monotropaceae
Monotropa	Monotropaceae
Monotropsis	Monotropaceae
Pityopus	Monotropaceae
Pleuricospora	Monotropaceae
Pterospora	Monotropaceae
Sarcodes	Monotropaceae
Artocarpus	Moraceae
Brosimum	Moraceae
Broussonetia	Moraceae
Castilla	Moraceae
Chlorophora	Moraceae
Cudrania	Moraceae
Dorstenia	Moraceae
Fatoua	Moraceae
Ficus	Moraceae
Maclura	Moraceae
Morus	Moraceae
Pseudolmedia	Moraceae
Streblus	Moraceae
Treculia	Moraceae
Trophis	Moraceae
Moringa	Moringaceae
Ensete	Musaceae
Musa	Musaceae
Bontia	Myoporaceae
Eremophila	Myoporaceae
Myoporum	Myoporaceae
Comptonia	Myricaceae
Morella	Myricaceae
Myrica	Myricaceae
Horsfieldia	Myristicaceae
Myristica	Myristicaceae
Virola	Myristicaceae
Ardisia	Myrsinaceae
Cybianthus	Myrsinaceae
Discocalyx	Myrsinaceae
Embelia	Myrsinaceae
Maesa	Myrsinaceae
Myrsine	Myrsinaceae
Parathesis	Myrsinaceae
Stylogyne	Myrsinaceae
Wallenia	Myrsinaceae
Baeckea	Myrtaceae
Callistemon	Myrtaceae
Calothamnus	Myrtaceae
Calyptranthes	Myrtaceae
Calytrix	Myrtaceae
Chamelaucium	Myrtaceae
Corymbia	Myrtaceae
Decaspermum	Myrtaceae
Eucalyptus	Myrtaceae
Eugenia	Myrtaceae
Feijoa	Myrtaceae
Gomidesia	Myrtaceae
Kunzea	Myrtaceae
Leptospermum	Myrtaceae
Lophostemon	Myrtaceae
Marlierea	Myrtaceae
Melaleuca	Myrtaceae
Metrosideros	Myrtaceae
Myrcia	Myrtaceae
Myrcianthes	Myrtaceae
Myrciaria	Myrtaceae
Myrtella	Myrtaceae
Myrtus	Myrtaceae
Pimenta	Myrtaceae
Pseudanamomis	Myrtaceae
Psidium	Myrtaceae
Rhodomyrtus	Myrtaceae
Siphoneugena	Myrtaceae
Syncarpia	Myrtaceae
Syzygium	Myrtaceae
Tristaniopsis	Myrtaceae
Ugni	Myrtaceae
Najas	Najadaceae
Nelumbo	Nelumbonaceae
Nepenthes	Nepenthaceae
Abronia	Nyctaginaceae
Acleisanthes	Nyctaginaceae
Allionia	Nyctaginaceae
Ammocodon	Nyctaginaceae
Anulocaulis	Nyctaginaceae
Boerhavia	Nyctaginaceae
Bougainvillea	Nyctaginaceae
Cyphomeris	Nyctaginaceae
Guapira	Nyctaginaceae
Mirabilis	Nyctaginaceae
Neea	Nyctaginaceae
Nyctaginia	Nyctaginaceae
Okenia	Nyctaginaceae
Pisonia	Nyctaginaceae
Selinocarpus	Nyctaginaceae
Tripterocalyx	Nyctaginaceae
Euryale	Nymphaeaceae
Nuphar	Nymphaeaceae
Nymphaea	Nymphaeaceae
Victoria	Nymphaeaceae
Ochna	Ochnaceae
Ouratea	Ochnaceae
Sauvagesia	Ochnaceae
Heisteria	Olacaceae
Ongokea	Olacaceae
Schoepfia	Olacaceae
Ximenia	Olacaceae
Chionanthus	Oleaceae
Fontanesia	Oleaceae
Forestiera	Oleaceae
Forsythia	Oleaceae
Fraxinus	Oleaceae
Haenianthus	Oleaceae
Jasminum	Oleaceae
Ligustrum	Oleaceae
Menodora	Oleaceae
Nestegis	Oleaceae
Noronhia	Oleaceae
Olea	Oleaceae
Osmanthus	Oleaceae
Syringa	Oleaceae
Calylophus	Onagraceae
Camissonia	Onagraceae
Chamerion	Onagraceae
Circaea	Onagraceae
Clarkia	Onagraceae
Epilobium	Onagraceae
Fuchsia	Onagraceae
Gaura	Onagraceae
Gayophytum	Onagraceae
Lopezia	Onagraceae
Ludwigia	Onagraceae
Oenothera	Onagraceae
Stenosiphon	Onagraceae
Botrychium	Ophioglossaceae
Cheiroglossa	Ophioglossaceae
Helminthostachys	Ophioglossaceae
Ophioglossum	Ophioglossaceae
Sceptridium	Ophioglossaceae
Amerorchis	Orchidaceae
Anoectochilus	Orchidaceae
Aplectrum	Orchidaceae
Arethusa	Orchidaceae
Arundina	Orchidaceae
Basiphyllaea	Orchidaceae
Beloglottis	Orchidaceae
Bletia	Orchidaceae
Bletilla	Orchidaceae
Brachionidium	Orchidaceae
Brassavola	Orchidaceae
Brassia	Orchidaceae
Broughtonia	Orchidaceae
Bulbophyllum	Orchidaceae
Caelogyne	Orchidaceae
Calanthe	Orchidaceae
Calopogon	Orchidaceae
Calypso	Orchidaceae
Campylocentrum	Orchidaceae
Catasetum	Orchidaceae
Cattleya	Orchidaceae
Caularthron	Orchidaceae
Cephalanthera	Orchidaceae
Cleistes	Orchidaceae
Cochleanthes	Orchidaceae
Comparettia	Orchidaceae
Corallorhiza	Orchidaceae
Corymborkis	Orchidaceae
Cranichis	Orchidaceae
Cyclopogon	Orchidaceae
Cymbidium	Orchidaceae
Cypripedium	Orchidaceae
Cyrtopodium	Orchidaceae
Dactylorhiza	Orchidaceae
Deiregyne	Orchidaceae
Dendrobium	Orchidaceae
Dendrophylax	Orchidaceae
Dichaea	Orchidaceae
Dichromanthus	Orchidaceae
Dilomilis	Orchidaceae
Domingoa	Orchidaceae
Elleanthus	Orchidaceae
Eltroplectris	Orchidaceae
Encyclia	Orchidaceae
Epidendrum	Orchidaceae
Epipactis	Orchidaceae
Erythrodes	Orchidaceae
Eulophia	Orchidaceae
Eurystyles	Orchidaceae
Galeandra	Orchidaceae
Galearis	Orchidaceae
Geodorum	Orchidaceae
Goodyera	Orchidaceae
Govenia	Orchidaceae
Gymnadenia	Orchidaceae
Habenaria	Orchidaceae
Hapalorchis	Orchidaceae
Harrisella	Orchidaceae
Helleriella	Orchidaceae
Hexalectris	Orchidaceae
Ionopsis	Orchidaceae
Isochilus	Orchidaceae
Isotria	Orchidaceae
Jacquiniella	Orchidaceae
Koellensteinia	Orchidaceae
Laelia	Orchidaceae
Leochilus	Orchidaceae
Lepanthes	Orchidaceae
Lepanthopsis	Orchidaceae
Liparis	Orchidaceae
Listera	Orchidaceae
Lycaste	Orchidaceae
Macradenia	Orchidaceae
Malaxis	Orchidaceae
Masdevallia	Orchidaceae
Maxillaria	Orchidaceae
Mesadenus	Orchidaceae
Miltonia	Orchidaceae
Nervilia	Orchidaceae
Nidema	Orchidaceae
Odontoglossum	Orchidaceae
Oeceoclades	Orchidaceae
Oncidium	Orchidaceae
Ophrys	Orchidaceae
Orchis	Orchidaceae
Paphiopedilum	Orchidaceae
Pelexia	Orchidaceae
Phaius	Orchidaceae
Phalaenopsis	Orchidaceae
Piperia	Orchidaceae
Platanthera	Orchidaceae
Platythelys	Orchidaceae
Pleurothallis	Orchidaceae
Pogonia	Orchidaceae
Polystachya	Orchidaceae
Ponthieva	Orchidaceae
Prescotia	Orchidaceae
Prosthechea	Orchidaceae
Psilochilus	Orchidaceae
Psychilis	Orchidaceae
Psychopsis	Orchidaceae
Pteroglossaspis	Orchidaceae
Renanthera	Orchidaceae
Restrepiella	Orchidaceae
Scaphyglottis	Orchidaceae
Schiedeella	Orchidaceae
Sobralia	Orchidaceae
Spathoglottis	Orchidaceae
Spiranthes	Orchidaceae
Stanhopea	Orchidaceae
Stelis	Orchidaceae
Stenorrhynchos	Orchidaceae
Tetramicra	Orchidaceae
Tipularia	Orchidaceae
Tolumnia	Orchidaceae
Trichocentrum	Orchidaceae
Trichosalpinx	Orchidaceae
Triphora	Orchidaceae
Tropidia	Orchidaceae
Vanda	Orchidaceae
Vanilla	Orchidaceae
Wullschlaegelia	Orchidaceae
Xylobium	Orchidaceae
Zeuxine	Orchidaceae
Aeginetia	Orobanchaceae
Boschniakia	Orobanchaceae
Conopholis	Orobanchaceae
Epifagus	Orobanchaceae
Orobanche	Orobanchaceae
Osmunda	Osmundaceae
Averrhoa	Oxalidaceae
Oxalis	Oxalidaceae
Paeonia	Paeoniaceae
Freycinetia	Pandanaceae
Pandanus	Pandanaceae
Arctomecon	Papaveraceae
Argemone	Papaveraceae
Bocconia	Papaveraceae
Canbya	Papaveraceae
Chelidonium	Papaveraceae
Dendromecon	Papaveraceae
Eschscholzia	Papaveraceae
Glaucium	Papaveraceae
Hunnemannia	Papaveraceae
Macleaya	Papaveraceae
Meconella	Papaveraceae
Papaver	Papaveraceae
Platystemon	Papaveraceae
Platystigma	Papaveraceae
Roemeria	Papaveraceae
Romneya	Papaveraceae
Sanguinaria	Papaveraceae
Stylomecon	Papaveraceae
Stylophorum	Papaveraceae
Ceratopteris	Parkeriaceae
Passiflora	Passifloraceae
Ceratotheca	Pedaliaceae
Craniolaria	Pedaliaceae
Harpagophytum	Pedaliaceae
Ibicella	Pedaliaceae
Martynia	Pedaliaceae
Proboscidea	Pedaliaceae
Sesamum	Pedaliaceae
Philydrum	Philydraceae
Agdestis	Phytolaccaceae
Gisekia	Phytolaccaceae
Petiveria	Phytolaccaceae
Phytolacca	Phytolaccaceae
Rivina	Phytolaccaceae
Stegnosperma	Phytolaccaceae
Trichostigma	Phytolaccaceae
Abies	Pinaceae
Cedrus	Pinaceae
Keteleeria	Pinaceae
Larix	Pinaceae
Picea	Pinaceae
Pinus	Pinaceae
Pseudolarix	Pinaceae
Pseudotsuga	Pinaceae
Tsuga	Pinaceae
Lepianthes	Piperaceae
Peperomia	Piperaceae
Piper	Piperaceae
Hymenosporum	Pittosporaceae
Pittosporum	Pittosporaceae
Sollya	Pittosporaceae
Littorella	Plantaginaceae
Plantago	Plantaginaceae
Platanus	Platanaceae
Armeria	Plumbaginaceae
Ceratostigma	Plumbaginaceae
Limonium	Plumbaginaceae
Plumbago	Plumbaginaceae
Achnatherum	Poaceae
Achnella	Poaceae
Acrachne	Poaceae
Acroceras	Poaceae
Aegilops	Poaceae
Aegopogon	Poaceae
Aeluropus	Poaceae
Agropogon	Poaceae
Agropyron	Poaceae
Agrostis	Poaceae
Aira	Poaceae
Allolepis	Poaceae
Alloteropsis	Poaceae
Alopecurus	Poaceae
Amblyopyrum	Poaceae
Ammocalamagrostis	Poaceae
Ammophila	Poaceae
Ampelodesmos	Poaceae
Amphibromus	Poaceae
Amphicarpum	Poaceae
Ancistrachne	Poaceae
Andropogon	Poaceae
Anthaenantia	Poaceae
Anthephora	Poaceae
Anthoxanthum	Poaceae
Apera	Poaceae
Apluda	Poaceae
Arctagrostis	Poaceae
Arctophila	Poaceae
Aristida	Poaceae
Arrhenatherum	Poaceae
Arthraxon	Poaceae
Arthrostylidium	Poaceae
Arundinaria	Poaceae
Arundinella	Poaceae
Arundo	Poaceae
Astrebla	Poaceae
Austrostipa	Poaceae
Avellinia	Poaceae
Avena	Poaceae
Avenula	Poaceae
Axonopus	Poaceae
Bambusa	Poaceae
Beckmannia	Poaceae
Blepharidachne	Poaceae
Blepharoneuron	Poaceae
Borinda	Poaceae
Bothriochloa	Poaceae
Bouteloua	Poaceae
Brachiaria	Poaceae
Brachyachne	Poaceae
Brachyelytrum	Poaceae
Brachypodium	Poaceae
Briza	Poaceae
Bromus	Poaceae
Calamagrostis	Poaceae
Calammophila	Poaceae
Calamovilfa	Poaceae
Calyptochloa	Poaceae
Castellia	Poaceae
Catabrosa	Poaceae
Catapodium	Poaceae
Cathestecum	Poaceae
Celtica	Poaceae
Cenchrus	Poaceae
Centotheca	Poaceae
Centropodia	Poaceae
Chasmanthium	Poaceae
Chloris	Poaceae
Chrysopogon	Poaceae
Chusquea	Poaceae
Cinna	Poaceae
Cladoraphis	Poaceae
Cleistachne	Poaceae
Cleistogenes	Poaceae
Coelorachis	Poaceae
Coix	Poaceae
Coleanthus	Poaceae
Cortaderia	Poaceae
Corynephorus	Poaceae
Cottea	Poaceae
Crypsis	Poaceae
Ctenium	Poaceae
Cutandia	Poaceae
Cymbopogon	Poaceae
Cynodon	Poaceae
Cynosurus	Poaceae
Cyrtococcum	Poaceae
Dactylis	Poaceae
Dactyloctenium	Poaceae
Danthonia	Poaceae
Danthoniopsis	Poaceae
Dasyochloa	Poaceae
Dasypyrum	Poaceae
Dendrocalamus	Poaceae
Deschampsia	Poaceae
Desmostachya	Poaceae
Diarrhena	Poaceae
Dichanthelium	Poaceae
Dichanthium	Poaceae
Dichelachne	Poaceae
Diectomis	Poaceae
Digitaria	Poaceae
Dimeria	Poaceae
Dinebra	Poaceae
Dissanthelium	Poaceae
Dissochondrus	Poaceae
Distichlis	Poaceae
Dupontia	Poaceae
Echinochloa	Poaceae
Echinopogon	Poaceae
Ehrharta	Poaceae
Eleusine	Poaceae
Elionurus	Poaceae
Elyhordeum	Poaceae
Elyleymus	Poaceae
Elymus	Poaceae
Elytrigia	Poaceae
Enneapogon	Poaceae
Enteropogon	Poaceae
Entolasia	Poaceae
Eragrostis	Poaceae
Eremochloa	Poaceae
Eremopyrum	Poaceae
Eriachne	Poaceae
Eriochloa	Poaceae
Eriochrysis	Poaceae
Erioneuron	Poaceae
Euclasta	Poaceae
Eulalia	Poaceae
Eulaliopsis	Poaceae
Eustachys	Poaceae
Festuca	Poaceae
Festulolium	Poaceae
Fingerhuthia	Poaceae
Garnotia	Poaceae
Gastridium	Poaceae
Gaudinia	Poaceae
Gigantochloa	Poaceae
Glyceria	Poaceae
Gymnopogon	Poaceae
Gynerium	Poaceae
Hackelochloa	Poaceae
Hainardia	Poaceae
Hakonechloa	Poaceae
Helictotrichon	Poaceae
Hemarthria	Poaceae
Hesperostipa	Poaceae
Heteranthelium	Poaceae
Heteropogon	Poaceae
Hierochloe	Poaceae
Hilaria	Poaceae
Holcus	Poaceae
Homolepis	Poaceae
Homopholis	Poaceae
Hordelymus	Poaceae
Hordeum	Poaceae
Hygroryza	Poaceae
Hymenachne	Poaceae
Hyparrhenia	Poaceae
Hypogynium	Poaceae
Ichnanthus	Poaceae
Imperata	Poaceae
Isachne	Poaceae
Ischaemum	Poaceae
Iseilema	Poaceae
Ixophorus	Poaceae
Jarava	Poaceae
Karroochloa	Poaceae
Koeleria	Poaceae
Lagurus	Poaceae
Lamarckia	Poaceae
Lasiacis	Poaceae
Lasiurus	Poaceae
Leersia	Poaceae
Leptochloa	Poaceae
Leptochloopsis	Poaceae
Leptocoryphium	Poaceae
Lepturus	Poaceae
Leucopoa	Poaceae
Leydeum	Poaceae
Leymus	Poaceae
Limnodea	Poaceae
Lithachne	Poaceae
Loliolum	Poaceae
Lolium	Poaceae
Loudetia	Poaceae
Luziola	Poaceae
Lycurus	Poaceae
Lygeum	Poaceae
Melica	Poaceae
Melinis	Poaceae
Merxmuellera	Poaceae
Mibora	Poaceae
Microchloa	Poaceae
Microlaena	Poaceae
Micropyrum	Poaceae
Microstegium	Poaceae
Milium	Poaceae
Miscanthus	Poaceae
Molinia	Poaceae
Monanthochloe	Poaceae
Monroa	Poaceae
Muhlenbergia	Poaceae
Nardus	Poaceae
Nassella	Poaceae
Neeragrostis	Poaceae
Neostapfia	Poaceae
Neyraudia	Poaceae
Ochthochloa	Poaceae
Olyra	Poaceae
Ophiuros	Poaceae
Oplismenus	Poaceae
Orcuttia	Poaceae
Oryza	Poaceae
Oryzopsis	Poaceae
Ottochloa	Poaceae
Oxychloris	Poaceae
Oxytenanthera	Poaceae
Panicum	Poaceae
Pappophorum	Poaceae
Parapholis	Poaceae
Pascopyrum	Poaceae
Paspalidium	Poaceae
Paspalum	Poaceae
Pennisetum	Poaceae
Perotis	Poaceae
Phalaris	Poaceae
Phanopyrum	Poaceae
Pharus	Poaceae
Phippsia	Poaceae
Phleum	Poaceae
Phragmites	Poaceae
Phyllostachys	Poaceae
Piptatherum	Poaceae
Piptochaetium	Poaceae
Plectrachne	Poaceae
Pleioblastus	Poaceae
Pleuraphis	Poaceae
Pleuropogon	Poaceae
Poa	Poaceae
Pogonatherum	Poaceae
Polypogon	Poaceae
Polytoca	Poaceae
Polytrias	Poaceae
Psathyrostachys	Poaceae
Pseudelymus	Poaceae
Pseudoroegneria	Poaceae
Pseudosasa	Poaceae
Psilurus	Poaceae
Ptilagrostis	Poaceae
Puccinellia	Poaceae
Redfieldia	Poaceae
Reimarochloa	Poaceae
Rostraria	Poaceae
Rottboellia	Poaceae
Rytidosperma	Poaceae
Saccharum	Poaceae
Sacciolepis	Poaceae
Sasa	Poaceae
Schedonnardus	Poaceae
Schedonorus	Poaceae
Schismus	Poaceae
Schizachne	Poaceae
Schizachyrium	Poaceae
Schizostachyum	Poaceae
Schmidtia	Poaceae
Sclerochloa	Poaceae
Scleropogon	Poaceae
Sclerostachya	Poaceae
Scolochloa	Poaceae
Scribneria	Poaceae
Secale	Poaceae
Sehima	Poaceae
Semiarundinaria	Poaceae
Sesleria	Poaceae
Setaria	Poaceae
Setariopsis	Poaceae
Shibataea	Poaceae
Sinocalamus	Poaceae
Snowdenia	Poaceae
Sorghastrum	Poaceae
Sorghum	Poaceae
Spartina	Poaceae
Sphenopholis	Poaceae
Spinifex	Poaceae
Spodiopogon	Poaceae
Sporobolus	Poaceae
Steinchisma	Poaceae
Stenotaphrum	Poaceae
Stipa	Poaceae
Stipagrostis	Poaceae
Swallenia	Poaceae
Taeniatherum	Poaceae
Tetrachne	Poaceae
Tetrapogon	Poaceae
Thaumastochloa	Poaceae
Themeda	Poaceae
Thinopyrum	Poaceae
Thuarea	Poaceae
Thyridolepis	Poaceae
Thysanolaena	Poaceae
Torreyochloa	Poaceae
Trachypogon	Poaceae
Tragus	Poaceae
Tribolium	Poaceae
Trichloris	Poaceae
Tricholaena	Poaceae
Trichoneura	Poaceae
Tridens	Poaceae
Triodia	Poaceae
Triplasis	Poaceae
Tripogon	Poaceae
Tripsacum	Poaceae
Triraphis	Poaceae
Trisetum	Poaceae
Triticosecale	Poaceae
Triticum	Poaceae
Tuctoria	Poaceae
Uniola	Poaceae
Urochloa	Poaceae
Vahlodea	Poaceae
Vaseyochloa	Poaceae
Ventenata	Poaceae
Vetiveria	Poaceae
Vossia	Poaceae
Vulpia	Poaceae
Whiteochloa	Poaceae
Willkommia	Poaceae
Zea	Poaceae
Zingeria	Poaceae
Zizania	Poaceae
Zizaniopsis	Poaceae
Zoysia	Poaceae
Afrocarpus	Podocarpaceae
Dacrycarpus	Podocarpaceae
Dacrydium	Podocarpaceae
Phyllocladus	Podocarpaceae
Podocarpus	Podocarpaceae
Saxegothaea	Podocarpaceae
Podostemum	Podostemaceae
Aliciella	Polemoniaceae
Allophyllum	Polemoniaceae
Cantua	Polemoniaceae
Collomia	Polemoniaceae
Eriastrum	Polemoniaceae
Gilia	Polemoniaceae
Giliastrum	Polemoniaceae
Gymnosteris	Polemoniaceae
Ipomopsis	Polemoniaceae
Langloisia	Polemoniaceae
Lathrocasis	Polemoniaceae
Leptodactylon	Polemoniaceae
Leptosiphon	Polemoniaceae
Linanthus	Polemoniaceae
Loeselia	Polemoniaceae
Loeseliastrum	Polemoniaceae
Microsteris	Polemoniaceae
Navarretia	Polemoniaceae
Phlox	Polemoniaceae
Polemonium	Polemoniaceae
Saltugilia	Polemoniaceae
Monnina	Polygalaceae
Nylandtia	Polygalaceae
Polygala	Polygalaceae
Salomonia	Polygalaceae
Securidaca	Polygalaceae
Antenoron	Polygonaceae
Antigonon	Polygonaceae
Aristocapsa	Polygonaceae
Brunnichia	Polygonaceae
Calligonum	Polygonaceae
Centrostegia	Polygonaceae
Chorizanthe	Polygonaceae
Coccoloba	Polygonaceae
Dedeckera	Polygonaceae
Dodecahema	Polygonaceae
Emex	Polygonaceae
Eriogonum	Polygonaceae
Fagopyrum	Polygonaceae
Gilmania	Polygonaceae
Goodmania	Polygonaceae
Hollisteria	Polygonaceae
Homalocladium	Polygonaceae
Johanneshowellia	Polygonaceae
Koenigia	Polygonaceae
Lastarriaea	Polygonaceae
Mucronea	Polygonaceae
Muehlenbeckia	Polygonaceae
Nemacaulis	Polygonaceae
Oxyria	Polygonaceae
Oxytheca	Polygonaceae
Polygonella	Polygonaceae
Polygonum	Polygonaceae
Pterostegia	Polygonaceae
Rheum	Polygonaceae
Rumex	Polygonaceae
Stenogonum	Polygonaceae
Systenotheca	Polygonaceae
Triplaris	Polygonaceae
Campyloneurum	Polypodiaceae
Lepisorus	Polypodiaceae
Microgramma	Polypodiaceae
Microsorum	Polypodiaceae
Neurodium	Polypodiaceae
Niphidium	Polypodiaceae
Pecluma	Polypodiaceae
Phlebodium	Polypodiaceae
Phymatosorus	Polypodiaceae
Platycerium	Polypodiaceae
Pleopeltis	Polypodiaceae
Polypodium	Polypodiaceae
Eichhornia	Pontederiaceae
Heteranthera	Pontederiaceae
Monochoria	Pontederiaceae
Pontederia	Pontederiaceae
Reussia	Pontederiaceae
Calandrinia	Portulacaceae
Cistanthe	Portulacaceae
Claytonia	Portulacaceae
Lewisia	Portulacaceae
Montia	Portulacaceae
Phemeranthus	Portulacaceae
Portulaca	Portulacaceae
Portulacaria	Portulacaceae
Talinopsis	Portulacaceae
Talinum	Portulacaceae
Posidonia	Posidoniaceae
Potamogeton	Potamogetonaceae
Stuckenia	Potamogetonaceae
Anagallis	Primulaceae
Androsace	Primulaceae
Cyclamen	Primulaceae
Dodecatheon	Primulaceae
Douglasia	Primulaceae
Glaux	Primulaceae
Hottonia	Primulaceae
Lysimachia	Primulaceae
Primula	Primulaceae
Samolus	Primulaceae
Trientalis	Primulaceae
Banksia	Proteaceae
Embothrium	Proteaceae
Grevillea	Proteaceae
Hakea	Proteaceae
Isopogon	Proteaceae
Leucospermum	Proteaceae
Macadamia	Proteaceae
Protea	Proteaceae
Stenocarpus	Proteaceae
Psilotum	Psilotaceae
Acrostichum	Pteridaceae
Adiantum	Pteridaceae
Anopteris	Pteridaceae
Argyrochosma	Pteridaceae
Aspidotis	Pteridaceae
Astrolepis	Pteridaceae
Bommeria	Pteridaceae
Cheilanthes	Pteridaceae
Coniogramme	Pteridaceae
Cryptogramma	Pteridaceae
Doryopteris	Pteridaceae
Eriosorus	Pteridaceae
Hemionitis	Pteridaceae
Notholaena	Pteridaceae
Pellaea	Pteridaceae
Pentagramma	Pteridaceae
Pityrogramma	Pteridaceae
Pteris	Pteridaceae
Punica	Punicaceae
Chimaphila	Pyrolaceae
Moneses	Pyrolaceae
Orthilia	Pyrolaceae
Pyrola	Pyrolaceae
Pilostyles	Rafflesiaceae
Aconitum	Ranunculaceae
Actaea	Ranunculaceae
Adonis	Ranunculaceae
Anemone	Ranunculaceae
Aquilegia	Ranunculaceae
Caltha	Ranunculaceae
Ceratocephala	Ranunculaceae
Clematis	Ranunculaceae
Consolida	Ranunculaceae
Coptis	Ranunculaceae
Delphinium	Ranunculaceae
Enemion	Ranunculaceae
Eranthis	Ranunculaceae
Helleborus	Ranunculaceae
Hepatica	Ranunculaceae
Hydrastis	Ranunculaceae
Kumlienia	Ranunculaceae
Myosurus	Ranunculaceae
Nigella	Ranunculaceae
Pulsatilla	Ranunculaceae
Ranunculus	Ranunculaceae
Thalictrum	Ranunculaceae
Trautvetteria	Ranunculaceae
Trollius	Ranunculaceae
Xanthorhiza	Ranunculaceae
Oligomeris	Resedaceae
Reseda	Resedaceae
Adolphia	Rhamnaceae
Alphitonia	Rhamnaceae
Auerodendron	Rhamnaceae
Berchemia	Rhamnaceae
Ceanothus	Rhamnaceae
Colletia	Rhamnaceae
Colubrina	Rhamnaceae
Condalia	Rhamnaceae
Frangula	Rhamnaceae
Gouania	Rhamnaceae
Hovenia	Rhamnaceae
Karwinskia	Rhamnaceae
Krugiodendron	Rhamnaceae
Maesopsis	Rhamnaceae
Paliurus	Rhamnaceae
Reynosia	Rhamnaceae
Rhamnus	Rhamnaceae
Sageretia	Rhamnaceae
Smythea	Rhamnaceae
Ziziphus	Rhamnaceae
Bruguiera	Rhizophoraceae
Cassipourea	Rhizophoraceae
Ceriops	Rhizophoraceae
Gynotroches	Rhizophoraceae
Rhizophora	Rhizophoraceae
Acaena	Rosaceae
Adenostoma	Rosaceae
Agrimonia	Rosaceae
Alchemilla	Rosaceae
Amelanchier	Rosaceae
Amelasorbus	Rosaceae
Aphanes	Rosaceae
Argentina	Rosaceae
Aruncus	Rosaceae
Cercocarpus	Rosaceae
Chaenomeles	Rosaceae
Chamaebatia	Rosaceae
Chamaebatiaria	Rosaceae
Chamaerhodos	Rosaceae
Coleogyne	Rosaceae
Comarum	Rosaceae
Cotoneaster	Rosaceae
Crataegus	Rosaceae
Cydonia	Rosaceae
Dalibarda	Rosaceae
Dasiphora	Rosaceae
Dryas	Rosaceae
Duchesnea	Rosaceae
Eriobotrya	Rosaceae
Exochorda	Rosaceae
Fallugia	Rosaceae
Filipendula	Rosaceae
Fragaria	Rosaceae
Geum	Rosaceae
Gillenia	Rosaceae
Heteromeles	Rosaceae
Holodiscus	Rosaceae
Horkelia	Rosaceae
Horkeliella	Rosaceae
Ivesia	Rosaceae
Kelseya	Rosaceae
Kerria	Rosaceae
Luetkea	Rosaceae
Lyonothamnus	Rosaceae
Malacomeles	Rosaceae
Malus	Rosaceae
Mespilus	Rosaceae
Neviusia	Rosaceae
Oemleria	Rosaceae
Osteomeles	Rosaceae
Peraphyllum	Rosaceae
Petrophyton	Rosaceae
Photinia	Rosaceae
Physocarpus	Rosaceae
Potentilla	Rosaceae
Prinsepia	Rosaceae
Prunus	Rosaceae
Pseudocydonia	Rosaceae
Purshia	Rosaceae
Pyracantha	Rosaceae
Pyrus	Rosaceae
Quillaja	Rosaceae
Rhaphiolepis	Rosaceae
Rhodotypos	Rosaceae
Rosa	Rosaceae
Rubus	Rosaceae
Sanguisorba	Rosaceae
Sibbaldia	Rosaceae
Sibbaldiopsis	Rosaceae
Sorbaria	Rosaceae
Sorbus	Rosaceae
Spiraea	Rosaceae
Spiraeanthus	Rosaceae
Stephanandra	Rosaceae
Vauquelinia	Rosaceae
Waldsteinia	Rosaceae
Aidia	Rubiaceae
Antirhea	Rubiaceae
Asperula	Rubiaceae
Bikkia	Rubiaceae
Bobea	Rubiaceae
Bouvardia	Rubiaceae
Calycophyllum	Rubiaceae
Casasia	Rubiaceae
Catesbaea	Rubiaceae
Cephaelis	Rubiaceae
Cephalanthus	Rubiaceae
Chiococca	Rubiaceae
Chione	Rubiaceae
Cinchona	Rubiaceae
Coccocypselum	Rubiaceae
Coffea	Rubiaceae
Coprosma	Rubiaceae
Crucianella	Rubiaceae
Cruciata	Rubiaceae
Crusea	Rubiaceae
Damnacanthus	Rubiaceae
Dentella	Rubiaceae
Diodia	Rubiaceae
Erithalis	Rubiaceae
Ernodea	Rubiaceae
Exostema	Rubiaceae
Faramea	Rubiaceae
Galium	Rubiaceae
Gardenia	Rubiaceae
Genipa	Rubiaceae
Geophila	Rubiaceae
Gonzalagunia	Rubiaceae
Gouldia	Rubiaceae
Guettarda	Rubiaceae
Hamelia	Rubiaceae
Hedyotis	Rubiaceae
Hillia	Rubiaceae
Houstonia	Rubiaceae
Hydnophytum	Rubiaceae
Hydrophylax	Rubiaceae
Ixora	Rubiaceae
Kelloggia	Rubiaceae
Lasianthus	Rubiaceae
Luculia	Rubiaceae
Lucya	Rubiaceae
Machaonia	Rubiaceae
Mitchella	Rubiaceae
Mitracarpus	Rubiaceae
Morinda	Rubiaceae
Mussaenda	Rubiaceae
Neolamarckia	Rubiaceae
Neolaugeria	Rubiaceae
Neonauclea	Rubiaceae
Oldenlandia	Rubiaceae
Oldenlandiopsis	Rubiaceae
Paederia	Rubiaceae
Palicourea	Rubiaceae
Pentanisia	Rubiaceae
Pentas	Rubiaceae
Pentodon	Rubiaceae
Phialanthus	Rubiaceae
Pinckneya	Rubiaceae
Psychotria	Rubiaceae
Psydrax	Rubiaceae
Putoria	Rubiaceae
Randia	Rubiaceae
Richardia	Rubiaceae
Rondeletia	Rubiaceae
Rubia	Rubiaceae
Sabicea	Rubiaceae
Sarcopygme	Rubiaceae
Schradera	Rubiaceae
Scolosanthus	Rubiaceae
Scyphiphora	Rubiaceae
Serissa	Rubiaceae
Sherardia	Rubiaceae
Spermacoce	Rubiaceae
Stenaria	Rubiaceae
Strumpfia	Rubiaceae
Tarenna	Rubiaceae
Timonius	Rubiaceae
Uncaria	Rubiaceae
Valantia	Rubiaceae
Vangueria	Rubiaceae
Ruppia	Ruppiaceae
Acronychia	Rutaceae
Aegle	Rutaceae
Agathosma	Rutaceae
Amyris	Rutaceae
Angostura	Rutaceae
Boronia	Rutaceae
Calodendrum	Rutaceae
Casimiroa	Rutaceae
Choisya	Rutaceae
Citroncirus	Rutaceae
Citrus	Rutaceae
Clausena	Rutaceae
Cneoridium	Rutaceae
Correa	Rutaceae
Dictamnus	Rutaceae
Eremocitrus	Rutaceae
Esenbeckia	Rutaceae
Flindersia	Rutaceae
Fortunella	Rutaceae
Glycosmis	Rutaceae
Helietta	Rutaceae
Limonia	Rutaceae
Melicope	Rutaceae
Microcitrus	Rutaceae
Murraya	Rutaceae
Phellodendron	Rutaceae
Pilocarpus	Rutaceae
Platydesma	Rutaceae
Poncirus	Rutaceae
Ptelea	Rutaceae
Ravenia	Rutaceae
Ruta	Rutaceae
Severinia	Rutaceae
Tetradium	Rutaceae
Thamnosma	Rutaceae
Triphasia	Rutaceae
Zanthoxylum	Rutaceae
Meliosma	Sabiaceae
Populus	Salicaceae
Salix	Salicaceae
Salvinia	Salviniaceae
Buckleya	Santalaceae
Comandra	Santalaceae
Exocarpos	Santalaceae
Geocaulon	Santalaceae
Misodendrum	Santalaceae
Nestronia	Santalaceae
Pyrularia	Santalaceae
Santalum	Santalaceae
Thesium	Santalaceae
Alectryon	Sapindaceae
Allophylus	Sapindaceae
Blighia	Sapindaceae
Cardiospermum	Sapindaceae
Cupania	Sapindaceae
Cupaniopsis	Sapindaceae
Dimocarpus	Sapindaceae
Dodonaea	Sapindaceae
Exothea	Sapindaceae
Filicium	Sapindaceae
Harpullia	Sapindaceae
Hypelate	Sapindaceae
Koelreuteria	Sapindaceae
Litchi	Sapindaceae
Matayba	Sapindaceae
Melicoccus	Sapindaceae
Nephelium	Sapindaceae
Paullinia	Sapindaceae
Sapindus	Sapindaceae
Schleichera	Sapindaceae
Serjania	Sapindaceae
Talisia	Sapindaceae
Thouinia	Sapindaceae
Tristiropsis	Sapindaceae
Ungnadia	Sapindaceae
Urvillea	Sapindaceae
Xanthoceras	Sapindaceae
Aesandra	Sapotaceae
Baillonella	Sapotaceae
Chrysophyllum	Sapotaceae
Madhuca	Sapotaceae
Manilkara	Sapotaceae
Micropholis	Sapotaceae
Mimusops	Sapotaceae
Nesoluma	Sapotaceae
Palaquium	Sapotaceae
Pouteria	Sapotaceae
Sapota	Sapotaceae
Sideroxylon	Sapotaceae
Synsepalum	Sapotaceae
Vitellaria	Sapotaceae
Darlingtonia	Sarraceniaceae
Sarracenia	Sarraceniaceae
Anemopsis	Saururaceae
Houttuynia	Saururaceae
Saururus	Saururaceae
Astilbe	Saxifragaceae
Bensoniella	Saxifragaceae
Bergenia	Saxifragaceae
Bolandra	Saxifragaceae
Boykinia	Saxifragaceae
Chrysosplenium	Saxifragaceae
Conimitella	Saxifragaceae
Darmera	Saxifragaceae
Elmera	Saxifragaceae
Heuchera	Saxifragaceae
Jepsonia	Saxifragaceae
Leptarrhena	Saxifragaceae
Lepuropetalon	Saxifragaceae
Lithophragma	Saxifragaceae
Mitella	Saxifragaceae
Parnassia	Saxifragaceae
Rodgersia	Saxifragaceae
Saxifraga	Saxifragaceae
Saxifragopsis	Saxifragaceae
Suksdorfia	Saxifragaceae
Sullivantia	Saxifragaceae
Telesonix	Saxifragaceae
Tellima	Saxifragaceae
Tiarella	Saxifragaceae
Tolmiea	Saxifragaceae
Scheuchzeria	Scheuchzeriaceae
Schisandra	Schisandraceae
Actinostachys	Schizaeaceae
Schizaea	Schizaeaceae
Agalinis	Scrophulariaceae
Alectra	Scrophulariaceae
Amphianthus	Scrophulariaceae
Angelonia	Scrophulariaceae
Antirrhinum	Scrophulariaceae
Aureolaria	Scrophulariaceae
Bacopa	Scrophulariaceae
Bellardia	Scrophulariaceae
Besseya	Scrophulariaceae
Brachystigma	Scrophulariaceae
Buchnera	Scrophulariaceae
Buttonia	Scrophulariaceae
Calceolaria	Scrophulariaceae
Capraria	Scrophulariaceae
Castilleja	Scrophulariaceae
Chaenorhinum	Scrophulariaceae
Chelone	Scrophulariaceae
Chionophila	Scrophulariaceae
Collinsia	Scrophulariaceae
Cordylanthus	Scrophulariaceae
Craterostigma	Scrophulariaceae
Cycnium	Scrophulariaceae
Cymbalaria	Scrophulariaceae
Dasistoma	Scrophulariaceae
Digitalis	Scrophulariaceae
Diplacus	Scrophulariaceae
Dopatrium	Scrophulariaceae
Epixiphium	Scrophulariaceae
Erinus	Scrophulariaceae
Euphrasia	Scrophulariaceae
Gambelia	Scrophulariaceae
Glossostigma	Scrophulariaceae
Gratiola	Scrophulariaceae
Hebe	Scrophulariaceae
Hemichaena	Scrophulariaceae
Holmgrenanthe	Scrophulariaceae
Howelliella	Scrophulariaceae
Keckiella	Scrophulariaceae
Kickxia	Scrophulariaceae
Lagotis	Scrophulariaceae
Leucophyllum	Scrophulariaceae
Leucospora	Scrophulariaceae
Limnophila	Scrophulariaceae
Limosella	Scrophulariaceae
Linaria	Scrophulariaceae
Lindernia	Scrophulariaceae
Lophospermum	Scrophulariaceae
Mabrya	Scrophulariaceae
Macranthera	Scrophulariaceae
Maurandella	Scrophulariaceae
Maurandya	Scrophulariaceae
Mazus	Scrophulariaceae
Mecardonia	Scrophulariaceae
Melampyrum	Scrophulariaceae
Micranthemum	Scrophulariaceae
Mimetanthe	Scrophulariaceae
Mimulus	Scrophulariaceae
Misopates	Scrophulariaceae
Mohavea	Scrophulariaceae
Nemesia	Scrophulariaceae
Neogaerrhinum	Scrophulariaceae
Nothochelone	Scrophulariaceae
Nuttallanthus	Scrophulariaceae
Odontites	Scrophulariaceae
Orthocarpus	Scrophulariaceae
Parentucellia	Scrophulariaceae
Paulownia	Scrophulariaceae
Pedicularis	Scrophulariaceae
Penstemon	Scrophulariaceae
Phygelius	Scrophulariaceae
Pseudolysimachion	Scrophulariaceae
Pseudorontium	Scrophulariaceae
Rhinanthus	Scrophulariaceae
Russelia	Scrophulariaceae
Sairocarpus	Scrophulariaceae
Schistophragma	Scrophulariaceae
Schwalbea	Scrophulariaceae
Scoparia	Scrophulariaceae
Scrophularia	Scrophulariaceae
Seymeria	Scrophulariaceae
Sopubia	Scrophulariaceae
Stemodia	Scrophulariaceae
Striga	Scrophulariaceae
Synthyris	Scrophulariaceae
Tonella	Scrophulariaceae
Torenia	Scrophulariaceae
Triphysaria	Scrophulariaceae
Verbascum	Scrophulariaceae
Veronica	Scrophulariaceae
Veronicastrum	Scrophulariaceae
Selaginella	Selaginellaceae
Ailanthus	Simaroubaceae
Alvaradoa	Simaroubaceae
Castela	Simaroubaceae
Holacantha	Simaroubaceae
Picramnia	Simaroubaceae
Picrasma	Simaroubaceae
Quassia	Simaroubaceae
Samadera	Simaroubaceae
Simarouba	Simaroubaceae
Simmondsia	Simmondsiaceae
Smilax	Smilacaceae
Acnistus	Solanaceae
Atropa	Solanaceae
Bouchetia	Solanaceae
Browallia	Solanaceae
Brugmansia	Solanaceae
Brunfelsia	Solanaceae
Calibrachoa	Solanaceae
Capsicum	Solanaceae
Cestrum	Solanaceae
Chamaesaracha	Solanaceae
Cyphomandra	Solanaceae
Datura	Solanaceae
Duboisia	Solanaceae
Fabiana	Solanaceae
Goetzea	Solanaceae
Hunzikeria	Solanaceae
Hyoscyamus	Solanaceae
Iochroma	Solanaceae
Jaborosa	Solanaceae
Jaltomata	Solanaceae
Leucophysalis	Solanaceae
Lycianthes	Solanaceae
Lycium	Solanaceae
Mandragora	Solanaceae
Margaranthus	Solanaceae
Nectouxia	Solanaceae
Nicandra	Solanaceae
Nicotiana	Solanaceae
Nierembergia	Solanaceae
Nothocestrum	Solanaceae
Oryctes	Solanaceae
Petunia	Solanaceae
Physalis	Solanaceae
Quincula	Solanaceae
Salpichroa	Solanaceae
Salpiglossis	Solanaceae
Schizanthus	Solanaceae
Solandra	Solanaceae
Solanum	Solanaceae
Streptosolen	Solanaceae
Withania	Solanaceae
Sonneratia	Sonneratiaceae
Sparganium	Sparganiaceae
Sphenoclea	Sphenocleaceae
Stackhousia	Stackhousiaceae
Staphylea	Staphyleaceae
Turpinia	Staphyleaceae
Croomia	Stemonaceae
Ayenia	Sterculiaceae
Brachychiton	Sterculiaceae
Chiranthodendron	Sterculiaceae
Cola	Sterculiaceae
Dombeya	Sterculiaceae
Firmiana	Sterculiaceae
Fremontodendron	Sterculiaceae
Guazuma	Sterculiaceae
Helicteres	Sterculiaceae
Heritiera	Sterculiaceae
Hermannia	Sterculiaceae
Kleinhovia	Sterculiaceae
Melochia	Sterculiaceae
Pentapetes	Sterculiaceae
Sterculia	Sterculiaceae
Theobroma	Sterculiaceae
Waltheria	Sterculiaceae
Ravenala	Strelitziaceae
Strelitzia	Strelitziaceae
Halesia	Styracaceae
Pterostyrax	Styracaceae
Styrax	Styracaceae
Suriana	Surianaceae
Symplocos	Symplocaceae
Tacca	Taccaceae
Tamarix	Tamaricaceae
Taxus	Taxaceae
Torreya	Taxaceae
Camellia	Theaceae
Cleyera	Theaceae
Eurya	Theaceae
Franklinia	Theaceae
Gordonia	Theaceae
Laplacea	Theaceae
Stewartia	Theaceae
Ternstroemia	Theaceae
Thelia	Theliaceae
Macrothelypteris	Thelypteridaceae
Phegopteris	Thelypteridaceae
Pneumatopteris	Thelypteridaceae
Pseudophegopteris	Thelypteridaceae
Sphaerostephanos	Thelypteridaceae
Thelypteris	Thelypteridaceae
Jacquinia	Theophrastaceae
Daphne	Thymelaeaceae
Daphnopsis	Thymelaeaceae
Dirca	Thymelaeaceae
Edgeworthia	Thymelaeaceae
Lagetta	Thymelaeaceae
Thymelaea	Thymelaeaceae
Wikstroemia	Thymelaeaceae
Clappertonia	Tiliaceae
Columbia	Tiliaceae
Corchorus	Tiliaceae
Entelea	Tiliaceae
Grewia	Tiliaceae
Heliocarpus	Tiliaceae
Luehea	Tiliaceae
Tilia	Tiliaceae
Trichospermum	Tiliaceae
Triumfetta	Tiliaceae
Trapa	Trapaceae
Sciaphila	Triuridaceae
Tropaeolum	Tropaeolaceae
Piriqueta	Turneraceae
Turnera	Turneraceae
Typha	Typhaceae
Celtis	Ulmaceae
Planera	Ulmaceae
Trema	Ulmaceae
Ulmus	Ulmaceae
Zelkova	Ulmaceae
Boehmeria	Urticaceae
Cypholophus	Urticaceae
Dendrocnide	Urticaceae
Elatostema	Urticaceae
Hesperocnide	Urticaceae
Laportea	Urticaceae
Maoutia	Urticaceae
Neraudia	Urticaceae
Parietaria	Urticaceae
Phenax	Urticaceae
Pilea	Urticaceae
Pipturus	Urticaceae
Pouzolzia	Urticaceae
Procris	Urticaceae
Rousselia	Urticaceae
Soleirolia	Urticaceae
Touchardia	Urticaceae
Urera	Urticaceae
Urtica	Urticaceae
Centranthus	Valerianaceae
Plectritis	Valerianaceae
Valeriana	Valerianaceae
Valerianella	Valerianaceae
Aegiphila	Verbenaceae
Aloysia	Verbenaceae
Avicennia	Verbenaceae
Bouchea	Verbenaceae
Callicarpa	Verbenaceae
Caryopteris	Verbenaceae
Citharexylum	Verbenaceae
Clerodendrum	Verbenaceae
Congea	Verbenaceae
Cornutia	Verbenaceae
Duranta	Verbenaceae
Faradaya	Verbenaceae
Glandularia	Verbenaceae
Gmelina	Verbenaceae
Holmskioldia	Verbenaceae
Lantana	Verbenaceae
Lippia	Verbenaceae
Nashia	Verbenaceae
Nesogenes	Verbenaceae
Petitia	Verbenaceae
Petrea	Verbenaceae
Phryma	Verbenaceae
Phyla	Verbenaceae
Premna	Verbenaceae
Priva	Verbenaceae
Stachytarpheta	Verbenaceae
Stylodon	Verbenaceae
Tamonea	Verbenaceae
Tectona	Verbenaceae
Tetraclea	Verbenaceae
Verbena	Verbenaceae
Vitex	Verbenaceae
Hybanthus	Violaceae
Isodendrion	Violaceae
Melicytus	Violaceae
Viola	Violaceae
Arceuthobium	Viscaceae
Korthalsella	Viscaceae
Loranthus	Viscaceae
Phoradendron	Viscaceae
Viscum	Viscaceae
Ampelopsis	Vitaceae
Cayratia	Vitaceae
Cissus	Vitaceae
Parthenocissus	Vitaceae
Tetrastigma	Vitaceae
Vitis	Vitaceae
Anetium	Vittariaceae
Antrophyum	Vittariaceae
Hecistopteris	Vittariaceae
Vittaria	Vittariaceae
Drimys	Winteraceae
Xyris	Xyridaceae
Encephalartos	Zamiaceae
Macrozamia	Zamiaceae
Naturtium	Brassicaceae
Zamia	Zamiaceae
Zannichellia	Zannichelliaceae
Aframomum	Zingiberaceae
Alpinia	Zingiberaceae
Amomum	Zingiberaceae
Mathiola	Brassicaceae
Boesenbergia	Zingiberaceae
Curcuma	Zingiberaceae
Specularia	Campanulaceae
Micrampelis	Cucurbitaceae
Elettaria	Zingiberaceae
Etlingera	Zingiberaceae
Hedychium	Zingiberaceae
Hitchenia	Zingiberaceae
Kaempferia	Zingiberaceae
Renealmia	Zingiberaceae
Zingiber	Zingiberaceae
Nanozostera	Zosteraceae
Phyllospadix	Zosteraceae
Zostera	Zosteraceae
Dracopsis	Asteraceae
Isopappus	Asteraceae
Eclipta	Asteraceae
Boebera	Asteraceae
Pepo	Cucurbitaceae
Actinomeris	Asteraceae
Balanites	Zygophyllaceae
Bulnesia	Zygophyllaceae
Fagonia	Zygophyllaceae
Guajacum	Zygophyllaceae
Kallstroemia	Zygophyllaceae
Larrea	Zygophyllaceae
Ximenesia	Asteraceae
Peganum	Zygophyllaceae
Tribulus	Zygophyllaceae
Zygophyllum	Zygophyllaceae
Poaceae	Buchloe
Poaceae	Leptoloma
Psoralea	Fabaceae
Petalostemum	Fabaceae
Acnida	Amaranthaceae
Acerates	Asclepiadaceae
Myzorrhiza	Orobanchaceae
Glecoma	Lamiaceae
Neomamillaria	Cactaceae
Schrankia	Fabaceae
Acmispon	Fabaceae
Asclepiodora	Asclepiadaceae
Peplis	Lythraceae
Isnardia	Onagraceae
Jussiaea	Onagraceae
Poinsettia	Euphorbiaceae
